machine,cash_count,cash_amount,credit_count,credit_amount,total_count,total_revenue,date
CGG_AP21-AU,318,651.75,53,197.40,371,849.15,20141201
CGG_BC13-AU,87,446.75,72,426.60,159,873.35,20141201
CGG_BC14-AU,118,571.10,130,772.60,248,1343.70,20141201
CGG_BC21-AU,287,1089.90,196,2134.95,483,3224.85,20141201
CGG_BC41-AU,298,1172.15,163,949.85,461,2122.00,20141201
CGG_BC42-AU,104,462.80,67,383.50,171,846.30,20141201
CGG_BC43-AU,281,1038.55,263,1520.20,544,2558.75,20141201
CGG_BR14-AU,81,256.15,13,54.35,94,310.50,20141201
CGG_BR15-AU,179,496.25,78,332.45,257,828.70,20141201
CGG_BR16-AU,229,482.80,30,121.25,259,604.05,20141201
CGG_BR22-AU,521,1308.60,109,389.80,630,1698.40,20141201
CGG_BR23-AU,615,1755.75,227,1198.45,842,2954.20,20141201
CGG_BR26-AU,762,1839.55,127,448.60,889,2288.15,20141201
CGG_BR31-AU,1005,2690.45,165,774.90,1170,3465.35,20141201
CGG_BR32-AU,890,2140.05,77,278.05,967,2418.10,20141201
CGG_BR33-AU,309,835.25,35,169.35,344,1004.60,20141201
CGG_BR34-AU,1402,3149.55,125,400.45,1527,3550.00,20141201
CGG_BR35-AU,1156,3179.05,155,690.40,1311,3869.45,20141201
CGG_BR41-AU,177,740.05,114,663.95,291,1404.00,20141201
CGG_BR42-AU,703,2014.70,150,649.95,853,2664.65,20141201
CGG_BR43-AU,132,560.60,94,552.50,226,1113.10,20141201
CGG_BR44-AU,368,1117.05,72,293.75,440,1410.80,20141201
CGG_BR45-AU,150,663.40,136,787.05,286,1450.45,20141201
CGG_BS11-AU,209,994.85,169,1002.75,378,1997.60,20141201
CGG_BS12-AU,528,1669.75,116,538.00,644,2207.75,20141201
CGG_BS13-AU,138,703.40,152,883.55,290,1586.95,20141201
CGG_BS16-AU,131,526.50,130,755.75,261,1282.25,20141201
CGG_BS17-AU,597,1936.90,103,819.20,700,2756.10,20141201
CGG_BS18-AU,578,1672.40,128,600.35,706,2272.75,20141201
CGG_BS21-AU,1430,3318.95,122,442.35,1552,3761.30,20141201
CGG_BS22-AU,971,2076.10,60,196.75,1031,2272.85,20141201
CGG_BS23-AU,982,2263.75,77,247.45,1059,2511.20,20141201
CGG_BS24-AU,1170,2393.85,101,296.65,1271,2690.50,20141201
CGG_BS25-AU,1242,2922.95,144,510.45,1386,3433.40,20141201
CGG_BS26-AU,1848,4261.50,178,582.25,2026,4843.75,20141201
CGG_BS27-AU,1990,5246.70,176,638.50,2166,5885.20,20141201
CGG_BS29-AU,819,2361.85,102,412.45,921,2774.30,20141201
CGG_BS31-AU,682,1936.95,76,290.50,758,2227.45,20141201
CGG_BS32-AU,1046,2882.05,106,381.05,1152,3263.10,20141201
CGG_BS34-AU,132,379.90,13,53.75,145,433.65,20141201
CGG_BS35-AU,749,2153.95,64,237.45,813,2391.40,20141201
CGG_BS36-AU,1756,5021.80,219,869.05,1975,5890.85,20141201
CGG_BS37-AU,1614,4672.85,178,662.30,1792,5335.15,20141201
CGG_BS51-AU,544,2037.40,121,651.75,665,2689.15,20141201
CGG_BS52-AU,284,1053.70,58,324.30,342,1378.00,20141201
CGG_BS53-AU,369,1413.50,90,516.15,459,1929.65,20141201
CGG_BS54-AU,500,1955.45,78,410.60,578,2366.05,20141201
CGG_CCX1-AU,141,687.60,205,2794.20,346,3481.80,20141201
CGG_CCX2-AU,183,1098.80,146,1872.40,329,2971.20,20141201
CGG_CCX3-AU,27,147.30,31,371.20,58,518.50,20141201
CGG_CCX4-AU,21,134.80,20,307.50,41,442.30,20141201
CGG_CCX5-AU,184,1573.95,146,2059.30,330,3633.25,20141201
CGG_CCX6-AU,41,245.35,62,940.60,103,1185.95,20141201
CGG_CL11-AU,829,2152.40,126,475.55,955,2627.95,20141201
CGG_CLX2-AU,990,2217.60,113,412.45,1103,2630.05,20141201
CGG_CPX1-AU,1891,6008.15,450,2157.50,2341,8165.65,20141201
CGG_CPX2-AU,1403,4605.55,305,1479.10,1708,6084.65,20141201
CGG_CS21-AU,902,2767.95,173,937.35,1075,3705.30,20141201
CGG_CS22-AU,608,1481.75,117,435.45,725,1917.20,20141201
CGG_CUX2-AU,276,741.10,68,264.85,344,1005.95,20141201
CGG_EB29-AU,509,1526.60,91,414.85,600,1941.45,20141201
CGG_EB31-AU,660,1896.35,103,436.70,763,2333.05,20141201
CGG_EB32-AU,843,2283.80,106,449.95,949,2733.75,20141201
CGG_EB33-AU,1330,3864.55,197,854.70,1527,4719.25,20141201
CGG_EB34-AU,457,1192.90,71,248.70,528,1441.60,20141201
CGG_EB35-AU,1201,3564.10,222,1019.10,1423,4583.20,20141201
CGG_EB36-AU,1229,3671.90,194,875.40,1423,4547.30,20141201
CGG_EB41-AU,798,2593.60,148,1159.35,946,3752.95,20141201
CGG_EB42-AU,164,645.95,102,594.25,266,1240.20,20141201
CGG_EB44-AU,134,529.65,134,788.50,268,1318.15,20141201
CGG_EB46-AU,127,567.95,91,522.95,218,1090.90,20141201
CGG_FM21-AU,421,1589.40,124,1306.25,545,2895.65,20141201
CGG_FM22-AU,316,1136.70,186,2339.30,502,3476.00,20141201
CGG_FM23-AU,293,1079.75,287,3559.20,580,4638.95,20141201
CGG_FM24-AU,337,1136.45,182,2451.85,519,3588.30,20141201
CGG_FS21-AU,311,1012.15,116,1154.25,427,2166.40,20141201
CGG_FS22-AU,215,617.35,50,235.55,265,852.90,20141201
CGG_FS23-AU,154,528.70,130,1669.85,284,2198.55,20141201
CGG_FS24-AU,275,693.40,64,330.60,339,1024.00,20141201
CGG_FS25-AU,342,945.15,85,456.80,427,1401.95,20141201
CGG_FS26-AU,291,812.10,76,378.10,367,1190.20,20141201
CGG_FS31-AU,726,1570.35,71,243.65,797,1814.00,20141201
CGG_FS32-AU,854,1991.00,99,348.60,953,2339.60,20141201
CGG_FS33-AU,1433,2818.80,94,278.60,1527,3097.40,20141201
CGG_GC13-AU,195,880.00,137,796.95,332,1676.95,20141201
CGG_GH11-AU,94,306.75,23,100.00,117,406.75,20141201
CGG_GH15-AU,198,593.85,58,256.20,256,850.05,20141201
CGG_GH21-AU,451,904.75,52,162.40,503,1067.15,20141201
CGG_GH23-AU,993,1829.10,143,481.60,1136,2310.70,20141201
CGG_GH24-AU,1561,2941.65,156,531.60,1717,3473.25,20141201
CGG_GH31-AU,1440,2572.10,132,424.10,1572,2996.20,20141201
CGG_GH32-AU,937,1753.50,114,393.00,1051,2146.50,20141201
CGG_GH33-AU,616,1483.90,57,228.60,673,1712.50,20141201
CGG_GH34-AU,945,2147.90,59,183.65,1004,2331.55,20141201
CGG_GH36-AU,1046,2454.20,64,219.30,1110,2673.50,20141201
CGG_GHX1-AU,728,2511.60,175,943.70,903,3455.30,20141201
CGG_GHX3-AU,434,1312.35,108,641.85,542,1954.20,20141201
CGG_GHX5-AU,348,1229.25,134,771.75,482,2001.00,20141201
CGG_GM11-AU,111,370.95,55,254.35,166,625.30,20141201
CGG_GM16-AU,148,457.35,38,161.25,186,618.60,20141201
CGG_HAY1-AU,322,2360.00,779,6830.15,1101,9190.15,20141201
CGG_HAY2-AU,392,2678.90,652,5748.30,1044,8427.20,20141201
CGG_HAY3-AU,809,3602.50,587,4954.70,1396,8557.20,20141201
CGG_JSX1-AU,1094,2476.50,116,378.00,1210,2854.50,20141201
CGG_JSX2-AU,1031,2263.00,143,491.65,1174,2754.65,20141201
CGG_LM11-AU,725,1440.60,107,390.35,832,1830.95,20141201
CGG_LM12-AU,640,988.05,41,92.95,681,1081.00,20141201
CGG_LM13-AU,0,0.00,0,0.00,0,0.00,20141201
CGG_LM14-AU,343,512.75,31,116.85,374,629.60,20141201
CGG_LM15-AU,492,987.65,47,175.55,539,1163.20,20141201
CGG_LM16-AU,861,1678.50,115,416.70,976,2095.20,20141201
CGG_LM30-AU,866,1703.80,65,188.60,931,1892.40,20141201
CGG_LM32-AU,1413,2503.80,94,268.55,1507,2772.35,20141201
CGG_LM41-AU,1204,2199.05,86,234.05,1290,2433.10,20141201
CGG_LM42-AU,1079,1986.10,65,181.75,1144,2167.85,20141201
CGG_LM43-AU,1546,2276.75,71,175.25,1617,2452.00,20141201
CGG_LM44-AU,1902,3013.70,119,347.20,2021,3360.90,20141201
CGG_LMX2-AU,170,604.10,106,1168.05,276,1772.15,20141201
CGG_LR11-AU,814,1728.80,61,215.55,875,1944.35,20141201
CGG_LR12-AU,1235,2484.35,99,265.90,1334,2750.25,20141201
CGG_LR13-AU,2108,4143.70,140,427.25,2248,4570.95,20141201
CGG_LR14-AU,901,1755.35,56,171.80,957,1927.15,20141201
CGG_LR15-AU,927,2208.60,120,418.60,1047,2627.20,20141201
CGG_LR16-AU,866,1972.30,122,434.30,988,2406.60,20141201
CGG_LR31-AU,318,972.60,58,306.85,376,1279.45,20141201
CGG_LR33-AU,541,1554.75,132,778.65,673,2333.40,20141201
CGG_LR43-AU,737,2076.55,87,332.40,824,2408.95,20141201
CGG_LR47-AU,969,2925.00,160,838.05,1129,3763.05,20141201
CGG_MB11-AU,869,2047.90,79,266.70,948,2314.60,20141201
CGG_MB12-AU,1340,2983.70,137,464.80,1477,3448.50,20141201
CGG_MB13-AU,722,1638.65,58,205.55,780,1844.20,20141201
CGG_MB14-AU,808,1692.30,56,193.70,864,1886.00,20141201
CGG_MB15-AU,553,1102.50,64,208.70,617,1311.20,20141201
CGG_MB16-AU,773,1534.85,55,166.10,828,1700.95,20141201
CGG_MB17-AU,905,1833.65,156,577.90,1061,2411.55,20141201
CGG_MB23-AU,1494,2695.25,115,354.90,1609,3050.15,20141201
CGG_MB31-AU,1744,3012.70,97,281.65,1841,3294.35,20141201
CGG_MB32-AU,1609,2572.35,107,311.00,1716,2883.35,20141201
CGG_MB33-AU,1822,3179.95,106,344.15,1928,3524.10,20141201
CGG_MB34-AU,1624,2567.45,94,245.40,1718,2812.85,20141201
CGG_MB35-AU,1260,2510.00,153,540.25,1413,3050.25,20141201
CGG_MB36-AU,2280,3648.55,135,396.45,2415,4045.00,20141201
CGG_MB37-AU,1217,2187.50,109,396.05,1326,2583.55,20141201
CGG_MB38-AU,1964,3161.55,77,215.90,2041,3377.45,20141201
CGG_MB41-AU,1608,2681.95,110,327.25,1718,3009.20,20141201
CGG_MB42-AU,943,2237.90,70,233.65,1013,2471.55,20141201
CGG_MB44-AU,1042,2294.10,72,254.90,1114,2549.00,20141201
CGG_MBX1-AU,1510,4127.50,199,739.80,1709,4867.30,20141201
CGG_MBX2-AU,1166,3134.90,206,767.85,1372,3902.75,20141201
CGG_MBX4-AU,794,2047.15,145,554.90,939,2602.05,20141201
CGG_MC21-AU,1199,2845.20,143,917.25,1342,3762.45,20141201
CGG_MC22-AU,1406,3414.80,119,582.90,1525,3997.70,20141201
CGG_MC23-AU,778,2002.05,79,503.65,857,2505.70,20141201
CGG_MC31-AU,640,1431.95,87,491.10,727,1923.05,20141201
CGG_MC32-AU,291,948.75,74,429.25,365,1378.00,20141201
CGG_MC33-AU,349,1212.50,91,599.30,440,1811.80,20141201
CGG_MK31-AU,216,784.95,57,311.15,273,1096.10,20141201
CGG_MK34-AU,200,595.15,43,167.40,243,762.55,20141201
CGG_MK35-AU,115,347.35,26,129.30,141,476.65,20141201
CGG_MM41-AU,1996,3842.10,129,370.25,2125,4212.35,20141201
CGG_MS10-AU,518,989.40,46,157.45,564,1146.85,20141201
CGG_MS11-AU,1206,2420.95,100,321.15,1306,2742.10,20141201
CGG_MS12-AU,1617,2783.30,168,528.45,1785,3311.75,20141201
CGG_MS21-AU,1629,3117.75,164,491.45,1793,3609.20,20141201
CGG_MS30-AU,640,1171.80,39,111.75,679,1283.55,20141201
CGG_MS31-AU,2074,4226.15,235,769.50,2309,4995.65,20141201
CGG_MS32-AU,1370,2612.15,130,437.25,1500,3049.40,20141201
CGG_MS41-AU,951,1913.05,86,261.75,1037,2174.80,20141201
CGG_MS42-AU,1580,2561.10,134,319.25,1714,2880.35,20141201
CGG_MS43-AU,1980,3770.25,175,532.70,2155,4302.95,20141201
CGG_MS44-AU,1511,2577.25,121,320.85,1632,2898.10,20141201
CGG_MS46-AU,1392,2400.95,31,67.35,1423,2468.30,20141201
CGG_MY21-AU,911,1738.65,68,224.20,979,1962.85,20141201
CGG_MY22-AU,922,2089.65,70,246.80,992,2336.45,20141201
CGG_MY23-AU,794,1718.65,49,165.50,843,1884.15,20141201
CGG_MY24-AU,861,1971.60,62,202.45,923,2174.05,20141201
CGG_MY25-AU,984,2127.90,75,233.60,1059,2361.50,20141201
CGG_MY26-AU,938,2310.35,55,181.80,993,2492.15,20141201
CGG_MY31-AU,515,1224.40,61,220.55,576,1444.95,20141201
CGG_MY32-AU,550,1386.25,51,177.95,601,1564.20,20141201
CGG_MY33-AU,293,813.65,53,241.85,346,1055.50,20141201
CGG_MY34-AU,286,950.30,46,190.55,332,1140.85,20141201
CGG_MY35-AU,253,661.25,32,129.35,285,790.60,20141201
CGG_MY41-AU,1658,3567.75,151,491.05,1809,4058.80,20141201
CGG_MY42-AU,2213,4270.15,135,410.45,2348,4680.60,20141201
CGG_MY43-AU,756,2179.65,12,43.70,768,2223.35,20141201
CGG_MY44-AU,411,1214.85,45,156.85,456,1371.70,20141201
CGG_MY45-AU,754,2303.30,116,479.30,870,2782.60,20141201
CGG_MY46-AU,1523,4792.75,157,605.50,1680,5398.25,20141201
CGG_MY47-AU,1166,3546.65,139,522.95,1305,4069.60,20141201
CGG_MY51-AU,904,3075.65,155,865.55,1059,3941.20,20141201
CGG_MY52-AU,848,3313.55,257,1819.30,1105,5132.85,20141201
CGG_MY53-AU,586,2055.20,114,608.05,700,2663.25,20141201
CGG_MY54-AU,850,3392.50,197,1411.75,1047,4804.25,20141201
CGG_MY55-AU,998,3532.45,183,920.50,1181,4452.95,20141201
CGG_MY56-AU,854,3552.45,246,1743.45,1100,5295.90,20141201
CGG_MY57-AU,842,3034.00,163,857.40,1005,3891.40,20141201
CGG_PNR1-AU,638,1926.40,232,696.00,870,2622.40,20141201
CGG_PNR2-AU,64,192.00,18,54.00,82,246.00,20141201
CGG_RBX4-AU,308,1018.25,76,330.55,384,1348.80,20141201
CGG_RBX5-AU,178,805.95,77,372.50,255,1178.45,20141201
CGG_RBX6-AU,397,1769.20,262,1280.55,659,3049.75,20141201
CGG_RBX7-AU,271,1150.00,233,1129.30,504,2279.30,20141201
CGG_RS11-AU,654,1087.35,49,132.25,703,1219.60,20141201
CGG_RS13-AU,498,734.25,34,126.80,532,861.05,20141201
CGG_RS14-AU,128,148.45,7,23.10,135,171.55,20141201
CGG_RS15-AU,702,1316.35,87,292.95,789,1609.30,20141201
CGG_RS16-AU,1394,2051.85,77,220.50,1471,2272.35,20141201
CGG_RS20-AU,1419,2248.20,99,257.10,1518,2505.30,20141201
CGG_RS21-AU,1547,2763.10,133,354.65,1680,3117.75,20141201
CGG_RS22-AU,2420,3864.35,139,394.60,2559,4258.95,20141201
CGG_RS23-AU,1776,3279.40,166,519.10,1942,3798.50,20141201
CGG_RS30-AU,1476,2691.00,127,373.40,1603,3064.40,20141201
CGG_RS31-AU,1529,3260.55,126,436.15,1655,3696.70,20141201
CGG_RS32-AU,888,1697.30,76,225.35,964,1922.65,20141201
CGG_RS33-AU,1105,2362.35,101,320.35,1206,2682.70,20141201
CGG_RS41-AU,1174,2363.10,118,360.90,1292,2724.00,20141201
CGG_RS42-AU,1250,2956.35,116,383.35,1366,3339.70,20141201
CGG_RS43-AU,706,1504.55,90,320.40,796,1824.95,20141201
CGG_RS44-AU,484,1179.95,59,209.30,543,1389.25,20141201
CGG_RS45-AU,1281,2604.45,101,307.40,1382,2911.85,20141201
CGG_RS46-AU,821,1958.55,89,322.40,910,2280.95,20141201
CGG_RS50-AU,462,943.60,0,0.00,462,943.60,20141201
CGG_RS53-AU,809,2053.25,110,377.45,919,2430.70,20141201
CGG_RSX1-AU,451,585.05,11,37.45,462,622.50,20141201
CGG_RSX2-AU,613,1186.25,46,166.75,659,1353.00,20141201
CGG_RSX3-AU,557,1182.80,27,106.25,584,1289.05,20141201
CGG_RT12-AU,950,2594.10,121,578.60,1071,3172.70,20141201
CGG_SS31-AU,807,1406.30,42,126.15,849,1532.45,20141201
CGG_SS32-AU,583,1079.15,38,148.05,621,1227.20,20141201
CGG_SW30-AU,359,1290.55,109,849.25,468,2139.80,20141201
CGG_SW31-AU,1038,3028.30,99,389.95,1137,3418.25,20141201
CGG_SW32-AU,434,1519.70,113,1151.25,547,2670.95,20141201
CGG_SW33-AU,424,1264.45,54,218.10,478,1482.55,20141201
CGG_SW34-AU,459,1875.55,198,1941.10,657,3816.65,20141201
CGG_SW35-AU,550,1691.35,83,335.55,633,2026.90,20141201
CGG_TM10-AU,1746,4851.00,415,1851.65,2161,6702.65,20141201
CGG_TMX3-AU,1241,4577.05,326,2243.55,1567,6820.60,20141201
CGG_TMX4-AU,1835,6192.00,329,2079.60,2164,8271.60,20141201
CGG_TMX5-AU,1819,5944.90,540,3956.55,2359,9901.45,20141201
CGG_TMX6-AU,1823,6476.80,530,3684.70,2353,10161.50,20141201
CGG_TMX7-AU,1198,3366.05,377,1689.15,1575,5055.20,20141201
CGG_TMX8-AU,1851,5475.95,995,4656.45,2846,10132.40,20141201
CGG_TMX9-AU,2222,6121.35,449,1949.00,2671,8070.35,20141201
CGG_TPX1-AU,866,1951.45,179,656.65,1045,2608.10,20141201
CGG_US10-AU,1222,2446.35,108,327.25,1330,2773.60,20141201
CGG_WB11-AU,74,350.35,87,514.35,161,864.70,20141201
CGG_WB12-AU,56,250.50,19,95.35,75,345.85,20141201
CGG_WB13-AU,61,299.30,96,563.60,157,862.90,20141201
CGG_WB14-AU,12,43.90,2,11.00,14,54.90,20141201
CGG_WB15-AU,87,401.00,139,826.25,226,1227.25,20141201
CGG_WB16-AU,166,685.85,83,416.05,249,1101.90,20141201
CGG_WBF1-AU,245,724.65,39,196.25,284,920.90,20141201
CGG_WBF2-AU,265,819.30,36,152.45,301,971.75,20141201
CGG_WES1-AU,382,1564.05,150,1112.40,532,2676.45,20141201
CGG_WES2-AU,640,2595.05,205,1358.00,845,3953.05,20141201
CGG_YA11-AU,781,1762.75,75,219.25,856,1982.00,20141201
CGG_YA13-AU,1764,3540.25,134,399.65,1898,3939.90,20141201
CGG_YA14-AU,964,2065.80,103,314.90,1067,2380.70,20141201
CGG_YA18-AU,1067,2359.70,113,356.70,1180,2716.40,20141201
CGG_YA20-AU,1524,3448.10,139,463.55,1663,3911.65,20141201
CGG_YA21-AU,1117,2276.55,92,277.40,1209,2553.95,20141201
CGG_YA23-AU,1042,2250.30,91,308.00,1133,2558.30,20141201
CGG_YA31-AU,1572,3658.00,132,460.45,1704,4118.45,20141201
CGG_YA32-AU,1152,2544.00,96,304.15,1248,2848.15,20141201
CGG_YA34-AU,979,2609.65,108,520.60,1087,3130.25,20141201
CGG_YA35-AU,978,2909.50,141,691.75,1119,3601.25,20141201
CGG_YA36-AU,727,1973.85,93,456.75,820,2430.60,20141201
CGG_YAX1-AU,867,2660.15,181,906.80,1048,3566.95,20141201
CGG_YAX2-AU,631,1908.90,127,542.35,758,2451.25,20141201
CGG_YAX3-AU,400,1221.65,66,349.35,466,1571.00,20141201
CGG_YAX4-AU,417,1311.65,103,531.20,520,1842.85,20141201
CGG_YCX1-AU,519,1517.85,95,569.30,614,2087.15,20141201
CGG_AP21-AU,411,975.40,99,369.85,510,1345.25,20141101
CGG_BC13-AU,15,47.90,4,20.50,19,68.40,20141101
CGG_BC14-AU,24,125.30,25,141.10,49,266.40,20141101
CGG_BC21-AU,271,1150.00,179,1969.25,450,3119.25,20141101
CGG_BC41-AU,322,1246.15,159,914.45,481,2160.60,20141101
CGG_BC42-AU,115,486.70,42,237.85,157,724.55,20141101
CGG_BC43-AU,172,742.00,272,1585.70,444,2327.70,20141101
CGG_BR14-AU,20,47.10,2,7.50,22,54.60,20141101
CGG_BR15-AU,65,192.30,9,40.00,74,232.30,20141101
CGG_BR16-AU,40,71.80,11,46.25,51,118.05,20141101
CGG_BR22-AU,415,982.40,88,315.45,503,1297.85,20141101
CGG_BR23-AU,562,1666.80,179,1015.60,741,2682.40,20141101
CGG_BR26-AU,771,1793.80,148,581.15,919,2374.95,20141101
CGG_BR31-AU,867,2203.10,119,564.25,986,2767.35,20141101
CGG_BR32-AU,776,1768.80,69,226.15,845,1994.95,20141101
CGG_BR33-AU,346,822.20,33,144.35,379,966.55,20141101
CGG_BR34-AU,1359,2813.80,98,350.60,1457,3164.40,20141101
CGG_BR35-AU,820,2171.85,114,524.30,934,2696.15,20141101
CGG_BR41-AU,128,545.05,127,728.60,255,1273.65,20141101
CGG_BR42-AU,546,1473.35,171,738.70,717,2212.05,20141101
CGG_BR43-AU,87,389.75,152,900.75,239,1290.50,20141101
CGG_BR44-AU,307,926.85,50,223.70,357,1150.55,20141101
CGG_BR45-AU,106,472.30,111,642.60,217,1114.90,20141101
CGG_BS11-AU,123,626.70,147,871.85,270,1498.55,20141101
CGG_BS12-AU,369,1239.80,81,429.35,450,1669.15,20141101
CGG_BS13-AU,159,881.45,157,922.95,316,1804.40,20141101
CGG_BS16-AU,94,438.70,132,771.95,226,1210.65,20141101
CGG_BS17-AU,507,1632.35,79,779.90,586,2412.25,20141101
CGG_BS18-AU,497,1291.00,109,542.65,606,1833.65,20141101
CGG_BS21-AU,1315,2968.35,93,346.10,1408,3314.45,20141101
CGG_BS22-AU,944,1751.70,64,207.45,1008,1959.15,20141101
CGG_BS23-AU,1022,2308.05,105,361.70,1127,2669.75,20141101
CGG_BS24-AU,1159,2407.45,90,273.55,1249,2681.00,20141101
CGG_BS25-AU,1324,3170.05,148,506.05,1472,3676.10,20141101
CGG_BS26-AU,1813,4242.65,152,487.20,1965,4729.85,20141101
CGG_BS27-AU,1995,5242.75,250,846.90,2245,6089.65,20141101
CGG_BS29-AU,876,2502.15,109,406.70,985,2908.85,20141101
CGG_BS31-AU,671,1936.25,72,274.95,743,2211.20,20141101
CGG_BS32-AU,1051,2938.55,123,434.90,1174,3373.45,20141101
CGG_BS34-AU,126,364.65,10,31.85,136,396.50,20141101
CGG_BS35-AU,692,1925.20,73,278.00,765,2203.20,20141101
CGG_BS36-AU,1856,5365.65,168,629.70,2024,5995.35,20141101
CGG_BS37-AU,1702,4827.20,179,691.75,1881,5518.95,20141101
CGG_BS51-AU,142,473.95,30,120.55,172,594.50,20141101
CGG_BS52-AU,87,338.45,18,105.00,105,443.45,20141101
CGG_BS53-AU,145,570.80,22,123.10,167,693.90,20141101
CGG_BS54-AU,145,571.85,24,110.60,169,682.45,20141101
CGG_CCX1-AU,206,1131.10,238,3017.80,444,4148.90,20141101
CGG_CCX2-AU,258,1635.85,168,2034.90,426,3670.75,20141101
CGG_CCX3-AU,44,263.80,32,339.30,76,603.10,20141101
CGG_CCX4-AU,23,172.80,40,513.10,63,685.90,20141101
CGG_CCX5-AU,165,1332.45,163,2132.90,328,3465.35,20141101
CGG_CCX6-AU,54,384.70,97,1477.40,151,1862.10,20141101
CGG_CL11-AU,711,1773.15,114,434.30,825,2207.45,20141101
CGG_CLX2-AU,782,1729.20,54,178.60,836,1907.80,20141101
CGG_CPX1-AU,1748,5113.80,244,1120.30,1992,6234.10,20141101
CGG_CPX2-AU,1124,3341.10,235,1031.70,1359,4372.80,20141101
CGG_CS21-AU,797,2617.85,158,882.40,955,3500.25,20141101
CGG_CS22-AU,596,1383.55,92,334.20,688,1717.75,20141101
CGG_CUX2-AU,151,347.15,51,201.25,202,548.40,20141101
CGG_EB29-AU,468,1388.80,73,324.25,541,1713.05,20141101
CGG_EB31-AU,671,1831.80,80,316.10,751,2147.90,20141101
CGG_EB32-AU,799,2111.60,104,448.05,903,2559.65,20141101
CGG_EB33-AU,1360,3651.80,179,742.90,1539,4394.70,20141101
CGG_EB34-AU,501,1185.00,44,178.75,545,1363.75,20141101
CGG_EB35-AU,1113,3148.00,171,747.95,1284,3895.95,20141101
CGG_EB36-AU,1142,3154.30,177,814.80,1319,3969.10,20141101
CGG_EB41-AU,712,2173.20,112,679.25,824,2852.45,20141101
CGG_EB42-AU,146,602.60,114,676.25,260,1278.85,20141101
CGG_EB44-AU,123,491.30,123,723.35,246,1214.65,20141101
CGG_EB46-AU,44,182.45,65,376.60,109,559.05,20141101
CGG_FM21-AU,511,2136.60,232,2412.20,743,4548.80,20141101
CGG_FM22-AU,401,1592.10,265,3508.70,666,5100.80,20141101
CGG_FM23-AU,365,1296.60,309,3934.25,674,5230.85,20141101
CGG_FM24-AU,370,1354.80,253,3293.50,623,4648.30,20141101
CGG_FS21-AU,339,1186.60,102,1030.55,441,2217.15,20141101
CGG_FS22-AU,331,1005.55,74,374.90,405,1380.45,20141101
CGG_FS23-AU,170,525.35,123,1612.45,293,2137.80,20141101
CGG_FS24-AU,338,1050.25,90,505.60,428,1555.85,20141101
CGG_FS25-AU,373,1119.05,108,591.20,481,1710.25,20141101
CGG_FS26-AU,350,1100.60,104,574.90,454,1675.50,20141101
CGG_FS31-AU,914,2057.90,90,288.50,1004,2346.40,20141101
CGG_FS32-AU,946,2201.85,111,430.45,1057,2632.30,20141101
CGG_FS33-AU,1753,3551.45,120,384.10,1873,3935.55,20141101
CGG_GC13-AU,173,767.10,158,915.25,331,1682.35,20141101
CGG_GH11-AU,17,35.85,2,6.25,19,42.10,20141101
CGG_GH15-AU,207,626.00,66,295.55,273,921.55,20141101
CGG_GH21-AU,665,1223.20,49,150.50,714,1373.70,20141101
CGG_GH23-AU,1478,2326.70,137,455.30,1615,2782.00,20141101
CGG_GH24-AU,2201,3755.25,181,543.15,2382,4298.40,20141101
CGG_GH31-AU,1481,2693.70,137,467.25,1618,3160.95,20141101
CGG_GH32-AU,1280,2447.65,132,424.80,1412,2872.45,20141101
CGG_GH33-AU,722,1806.45,68,282.40,790,2088.85,20141101
CGG_GH34-AU,1193,2876.25,100,353.05,1293,3229.30,20141101
CGG_GH36-AU,1276,3045.95,78,262.30,1354,3308.25,20141101
CGG_GHX1-AU,829,2448.50,190,949.80,1019,3398.30,20141101
CGG_GHX3-AU,486,1343.40,131,679.15,617,2022.55,20141101
CGG_GHX5-AU,358,1086.00,105,597.45,463,1683.45,20141101
CGG_GM11-AU,123,425.90,43,201.20,166,627.10,20141101
CGG_GM16-AU,169,505.80,41,174.35,210,680.15,20141101
CGG_HAY1-AU,345,2675.65,864,7518.40,1209,10194.05,20141101
CGG_HAY2-AU,376,2681.15,777,6750.35,1153,9431.50,20141101
CGG_HAY3-AU,756,4169.95,583,4823.80,1339,8993.75,20141101
CGG_JSX1-AU,1171,2464.95,139,465.35,1310,2930.30,20141101
CGG_JSX2-AU,1269,2581.40,147,489.80,1416,3071.20,20141101
CGG_LM11-AU,871,1654.25,117,404.75,988,2059.00,20141101
CGG_LM12-AU,678,1066.40,70,229.20,748,1295.60,20141101
CGG_LM13-AU,0,0.00,0,0.00,0,0.00,20141101
CGG_LM14-AU,423,679.10,45,169.30,468,848.40,20141101
CGG_LM15-AU,588,1123.90,69,238.00,657,1361.90,20141101
CGG_LM16-AU,923,1881.35,141,507.85,1064,2389.20,20141101
CGG_LM30-AU,984,1734.95,64,183.00,1048,1917.95,20141101
CGG_LM32-AU,1465,2478.45,99,274.05,1564,2752.50,20141101
CGG_LM41-AU,1110,1928.20,61,159.80,1171,2088.00,20141101
CGG_LM42-AU,902,1524.25,74,224.20,976,1748.45,20141101
CGG_LM43-AU,1577,2064.60,90,232.00,1667,2296.60,20141101
CGG_LM44-AU,1789,2727.95,119,355.30,1908,3083.25,20141101
CGG_LMX2-AU,224,1065.90,129,1615.55,353,2681.45,20141101
CGG_LR11-AU,905,1843.00,63,194.90,968,2037.90,20141101
CGG_LR12-AU,1369,2753.90,84,243.00,1453,2996.90,20141101
CGG_LR13-AU,2229,4597.25,148,445.30,2377,5042.55,20141101
CGG_LR14-AU,1010,2028.00,70,214.85,1080,2242.85,20141101
CGG_LR15-AU,412,1229.05,114,536.60,526,1765.65,20141101
CGG_LR16-AU,1026,2388.60,128,441.70,1154,2830.30,20141101
CGG_LR31-AU,334,1041.25,45,237.40,379,1278.65,20141101
CGG_LR33-AU,535,1622.45,150,913.10,685,2535.55,20141101
CGG_LR43-AU,776,2138.05,74,314.30,850,2452.35,20141101
CGG_LR47-AU,1065,3266.40,153,736.75,1218,4003.15,20141101
CGG_MB11-AU,804,1725.70,65,217.45,869,1943.15,20141101
CGG_MB12-AU,1202,2456.15,116,365.40,1318,2821.55,20141101
CGG_MB13-AU,753,1510.35,80,236.10,833,1746.45,20141101
CGG_MB14-AU,871,1752.40,70,203.60,941,1956.00,20141101
CGG_MB15-AU,542,1050.10,57,191.75,599,1241.85,20141101
CGG_MB16-AU,755,1412.10,66,215.50,821,1627.60,20141101
CGG_MB17-AU,987,1804.50,122,426.00,1109,2230.50,20141101
CGG_MB23-AU,1358,2284.25,89,243.45,1447,2527.70,20141101
CGG_MB31-AU,1935,3096.65,121,302.00,2056,3398.65,20141101
CGG_MB32-AU,1607,2447.70,89,213.45,1696,2661.15,20141101
CGG_MB33-AU,1758,2983.55,120,325.10,1878,3308.65,20141101
CGG_MB34-AU,1661,2432.70,67,182.95,1728,2615.65,20141101
CGG_MB35-AU,1028,2121.70,104,403.00,1132,2524.70,20141101
CGG_MB36-AU,2195,3347.05,106,315.85,2301,3662.90,20141101
CGG_MB37-AU,965,1634.55,97,320.40,1062,1954.95,20141101
CGG_MB38-AU,1717,2769.05,61,166.70,1778,2935.75,20141101
CGG_MB41-AU,1451,2526.80,78,261.70,1529,2788.50,20141101
CGG_MB42-AU,910,2209.05,86,291.00,996,2500.05,20141101
CGG_MB44-AU,839,1883.60,65,221.80,904,2105.40,20141101
CGG_MBX1-AU,1314,3416.05,177,634.85,1491,4050.90,20141101
CGG_MBX2-AU,1065,2783.70,178,652.40,1243,3436.10,20141101
CGG_MBX4-AU,861,2183.00,122,450.40,983,2633.40,20141101
CGG_MC21-AU,1226,3160.95,151,1051.75,1377,4212.70,20141101
CGG_MC22-AU,1515,3867.20,114,732.85,1629,4600.05,20141101
CGG_MC23-AU,843,2232.65,82,378.65,925,2611.30,20141101
CGG_MC31-AU,134,328.65,19,99.30,153,427.95,20141101
CGG_MC32-AU,84,262.00,9,79.35,93,341.35,20141101
CGG_MC33-AU,76,265.25,20,95.00,96,360.25,20141101
CGG_MK31-AU,183,710.35,30,157.45,213,867.80,20141101
CGG_MK34-AU,200,584.55,43,230.00,243,814.55,20141101
CGG_MK35-AU,118,346.85,21,109.35,139,456.20,20141101
CGG_MM41-AU,1958,3436.65,104,274.65,2062,3711.30,20141101
CGG_MS10-AU,485,837.15,51,168.05,536,1005.20,20141101
CGG_MS11-AU,1164,2175.95,111,341.75,1275,2517.70,20141101
CGG_MS12-AU,1622,2788.90,156,463.95,1778,3252.85,20141101
CGG_MS21-AU,1188,2174.15,126,377.15,1314,2551.30,20141101
CGG_MS30-AU,758,1291.55,57,176.20,815,1467.75,20141101
CGG_MS31-AU,1971,3783.80,219,695.95,2190,4479.75,20141101
CGG_MS32-AU,1254,2188.65,125,364.70,1379,2553.35,20141101
CGG_MS41-AU,934,1709.75,67,176.60,1001,1886.35,20141101
CGG_MS42-AU,1708,2392.90,122,258.65,1830,2651.55,20141101
CGG_MS43-AU,1792,3162.50,146,408.95,1938,3571.45,20141101
CGG_MS44-AU,1518,2340.20,90,191.30,1608,2531.50,20141101
CGG_MS46-AU,1288,1949.70,65,167.95,1353,2117.65,20141101
CGG_MY21-AU,1054,2162.40,65,214.25,1119,2376.65,20141101
CGG_MY22-AU,1034,2395.10,101,347.30,1135,2742.40,20141101
CGG_MY23-AU,884,1925.85,50,150.55,934,2076.40,20141101
CGG_MY24-AU,876,2016.70,66,229.95,942,2246.65,20141101
CGG_MY25-AU,1081,2254.70,76,241.05,1157,2495.75,20141101
CGG_MY26-AU,903,2249.95,76,253.00,979,2502.95,20141101
CGG_MY31-AU,656,1674.40,95,363.60,751,2038.00,20141101
CGG_MY32-AU,592,1518.15,69,227.20,661,1745.35,20141101
CGG_MY33-AU,393,1031.70,70,293.70,463,1325.40,20141101
CGG_MY34-AU,371,1111.75,44,179.30,415,1291.05,20141101
CGG_MY35-AU,326,913.10,48,205.60,374,1118.70,20141101
CGG_MY41-AU,1707,3758.40,141,483.60,1848,4242.00,20141101
CGG_MY42-AU,2210,4291.25,173,508.45,2383,4799.70,20141101
CGG_MY43-AU,878,2567.00,31,123.75,909,2690.75,20141101
CGG_MY44-AU,488,1499.85,50,207.50,538,1707.35,20141101
CGG_MY45-AU,768,2418.60,107,404.25,875,2822.85,20141101
CGG_MY46-AU,1637,5062.35,138,516.10,1775,5578.45,20141101
CGG_MY47-AU,1197,3669.05,158,601.10,1355,4270.15,20141101
CGG_MY51-AU,900,3046.45,131,662.40,1031,3708.85,20141101
CGG_MY52-AU,863,3417.80,240,1778.60,1103,5196.40,20141101
CGG_MY53-AU,692,2385.60,105,551.10,797,2936.70,20141101
CGG_MY54-AU,842,3343.00,228,1652.90,1070,4995.90,20141101
CGG_MY55-AU,1068,3877.70,168,877.95,1236,4755.65,20141101
CGG_MY56-AU,934,3983.60,267,1909.75,1201,5893.35,20141101
CGG_MY57-AU,870,3059.90,180,929.85,1050,3989.75,20141101
CGG_PNR1-AU,694,2098.40,231,693.00,925,2791.40,20141101
CGG_PNR2-AU,74,225.00,13,39.00,87,264.00,20141101
CGG_RBX4-AU,170,591.05,50,213.75,220,804.80,20141101
CGG_RBX5-AU,231,1026.55,111,535.00,342,1561.55,20141101
CGG_RBX6-AU,312,1464.65,290,1422.40,602,2887.05,20141101
CGG_RBX7-AU,266,1102.75,216,1032.40,482,2135.15,20141101
CGG_RS11-AU,830,1307.65,40,141.80,870,1449.45,20141101
CGG_RS13-AU,517,822.55,49,181.20,566,1003.75,20141101
CGG_RS14-AU,1480,1927.75,42,78.45,1522,2006.20,20141101
CGG_RS15-AU,796,1469.15,87,294.15,883,1763.30,20141101
CGG_RS16-AU,1253,1928.15,66,186.05,1319,2114.20,20141101
CGG_RS20-AU,1290,1955.65,109,330.95,1399,2286.60,20141101
CGG_RS21-AU,1611,2830.20,118,319.65,1729,3149.85,20141101
CGG_RS22-AU,2359,3684.80,133,349.70,2492,4034.50,20141101
CGG_RS23-AU,1638,2914.55,135,387.80,1773,3302.35,20141101
CGG_RS30-AU,1414,2527.30,102,320.95,1516,2848.25,20141101
CGG_RS31-AU,1481,2776.75,154,451.55,1635,3228.30,20141101
CGG_RS32-AU,915,1841.70,58,189.95,973,2031.65,20141101
CGG_RS33-AU,1107,2229.00,97,298.50,1204,2527.50,20141101
CGG_RS41-AU,1349,2593.60,81,248.65,1430,2842.25,20141101
CGG_RS42-AU,1323,3059.65,120,429.10,1443,3488.75,20141101
CGG_RS43-AU,724,1448.15,95,316.80,819,1764.95,20141101
CGG_RS44-AU,540,1245.15,46,148.65,586,1393.80,20141101
CGG_RS45-AU,1256,2520.00,104,329.20,1360,2849.20,20141101
CGG_RS46-AU,835,2000.10,77,276.75,912,2276.85,20141101
CGG_RS50-AU,451,942.60,6,15.00,457,957.60,20141101
CGG_RS53-AU,787,1943.55,99,378.65,886,2322.20,20141101
CGG_RSX1-AU,424,616.35,18,43.65,442,660.00,20141101
CGG_RSX2-AU,671,1404.10,42,147.40,713,1551.50,20141101
CGG_RSX3-AU,556,1174.45,58,194.15,614,1368.60,20141101
CGG_RT12-AU,1117,2809.45,135,647.65,1252,3457.10,20141101
CGG_SS31-AU,741,1392.45,51,216.15,792,1608.60,20141101
CGG_SS32-AU,606,1163.25,35,139.30,641,1302.55,20141101
CGG_SW30-AU,277,903.25,75,777.40,352,1680.65,20141101
CGG_SW31-AU,960,2828.65,116,447.95,1076,3276.60,20141101
CGG_SW32-AU,290,1128.45,122,1569.95,412,2698.40,20141101
CGG_SW33-AU,518,1564.85,55,215.55,573,1780.40,20141101
CGG_SW34-AU,388,1695.10,185,2216.70,573,3911.80,20141101
CGG_SW35-AU,712,2222.40,76,312.50,788,2534.90,20141101
CGG_TM10-AU,1567,4323.15,409,1820.95,1976,6144.10,20141101
CGG_TMX3-AU,932,3389.45,300,2038.65,1232,5428.10,20141101
CGG_TMX4-AU,1510,5207.55,273,1754.15,1783,6961.70,20141101
CGG_TMX5-AU,1519,5048.50,558,4052.80,2077,9101.30,20141101
CGG_TMX6-AU,1479,5343.10,483,3370.15,1962,8713.25,20141101
CGG_TMX7-AU,1029,2986.00,324,1467.35,1353,4453.35,20141101
CGG_TMX8-AU,1762,5294.35,1117,5248.15,2879,10542.50,20141101
CGG_TMX9-AU,2294,6313.75,530,2305.75,2824,8619.50,20141101
CGG_TPX1-AU,963,2069.65,176,651.75,1139,2721.40,20141101
CGG_US10-AU,1194,2296.85,87,256.80,1281,2553.65,20141101
CGG_WB11-AU,16,90.20,20,120.00,36,210.20,20141101
CGG_WB12-AU,11,52.55,2,10.50,13,63.05,20141101
CGG_WB13-AU,14,84.00,29,174.00,43,258.00,20141101
CGG_WB14-AU,20,76.20,6,29.50,26,105.70,20141101
CGG_WB15-AU,27,123.70,25,150.00,52,273.70,20141101
CGG_WB16-AU,30,114.00,21,108.35,51,222.35,20141101
CGG_WBF1-AU,33,79.65,8,30.60,41,110.25,20141101
CGG_WBF2-AU,54,155.40,1,3.75,55,159.15,20141101
CGG_WBF2OLD-AU,5,16.80,0,0.00,5,16.80,20141101
CGG_WES1-AU,440,1937.20,148,1094.25,588,3031.45,20141101
CGG_WES2-AU,637,2783.25,186,1227.25,823,4010.50,20141101
CGG_YA11-AU,708,1452.10,60,210.50,768,1662.60,20141101
CGG_YA13-AU,1668,3135.75,139,437.85,1807,3573.60,20141101
CGG_YA14-AU,1181,2338.25,95,297.40,1276,2635.65,20141101
CGG_YA18-AU,1059,2091.95,85,251.05,1144,2343.00,20141101
CGG_YA20-AU,1446,2954.70,153,528.50,1599,3483.20,20141101
CGG_YA21-AU,1115,1983.25,68,199.90,1183,2183.15,20141101
CGG_YA23-AU,910,1787.95,84,269.90,994,2057.85,20141101
CGG_YA31-AU,1512,3528.65,137,454.75,1649,3983.40,20141101
CGG_YA32-AU,1111,2409.65,81,263.65,1192,2673.30,20141101
CGG_YA34-AU,1001,2569.35,94,452.45,1095,3021.80,20141101
CGG_YA35-AU,952,2764.90,126,653.10,1078,3418.00,20141101
CGG_YA36-AU,650,1830.80,100,516.05,750,2346.85,20141101
CGG_YAX1-AU,766,2210.75,122,561.15,888,2771.90,20141101
CGG_YAX2-AU,688,1942.20,77,311.80,765,2254.00,20141101
CGG_YAX3-AU,281,813.75,60,311.80,341,1125.55,20141101
CGG_YAX4-AU,362,1040.60,84,430.60,446,1471.20,20141101
CGG_YCX1-AU,378,1080.40,69,413.05,447,1493.45,20141101
CGG_AP21-AU,501,1169.00,84,367.50,585,1536.50,20141001
CGG_BC21-AU,275,1158.80,168,2184.35,443,3343.15,20141001
CGG_BC41-AU,323,1234.30,153,896.70,476,2131.00,20141001
CGG_BC42-AU,136,578.20,42,220.85,178,799.05,20141001
CGG_BC43-AU,205,872.80,292,1716.85,497,2589.65,20141001
CGG_BR22-AU,471,1212.30,82,349.95,553,1562.25,20141001
CGG_BR23-AU,681,2098.00,182,1041.85,863,3139.85,20141001
CGG_BR26-AU,813,1847.45,120,457.40,933,2304.85,20141001
CGG_BR31-AU,875,2383.85,88,436.15,963,2820.00,20141001
CGG_BR32-AU,776,1747.20,53,193.75,829,1940.95,20141001
CGG_BR33-AU,348,858.45,47,219.35,395,1077.80,20141001
CGG_BR34-AU,1439,2836.00,72,214.25,1511,3050.25,20141001
CGG_BR35-AU,881,2271.10,50,207.45,931,2478.55,20141001
CGG_BR41-AU,148,629.10,123,707.10,271,1336.20,20141001
CGG_BR42-AU,650,1613.30,130,581.20,780,2194.50,20141001
CGG_BR43-AU,92,435.30,161,927.40,253,1362.70,20141001
CGG_BR44-AU,313,983.80,51,231.20,364,1215.00,20141001
CGG_BR45-AU,84,402.95,98,577.85,182,980.80,20141001
CGG_BS11-AU,152,838.75,213,1271.60,365,2110.35,20141001
CGG_BS12-AU,345,1071.60,57,300.60,402,1372.20,20141001
CGG_BS13-AU,150,838.60,103,613.50,253,1452.10,20141001
CGG_BS16-AU,73,367.25,131,777.10,204,1144.35,20141001
CGG_BS17-AU,537,1609.45,64,473.10,601,2082.55,20141001
CGG_BS18-AU,506,1378.50,108,550.95,614,1929.45,20141001
CGG_BS21-AU,1363,3089.95,74,248.00,1437,3337.95,20141001
CGG_BS22-AU,993,1901.80,61,188.70,1054,2090.50,20141001
CGG_BS23-AU,1112,2517.35,99,322.45,1211,2839.80,20141001
CGG_BS24-AU,1132,2371.05,96,323.05,1228,2694.10,20141001
CGG_BS25-AU,1401,3359.55,112,420.00,1513,3779.55,20141001
CGG_BS26-AU,1926,4568.35,160,562.45,2086,5130.80,20141001
CGG_BS27-AU,2264,5958.10,154,563.65,2418,6521.75,20141001
CGG_BS29-AU,890,2579.90,72,275.00,962,2854.90,20141001
CGG_BS31-AU,790,2268.05,69,263.05,859,2531.10,20141001
CGG_BS32-AU,1069,2909.50,100,381.80,1169,3291.30,20141001
CGG_BS34-AU,182,524.10,6,25.00,188,549.10,20141001
CGG_BS35-AU,736,2123.40,56,231.25,792,2354.65,20141001
CGG_BS36-AU,1879,5407.80,184,729.25,2063,6137.05,20141001
CGG_BS37-AU,1780,5202.70,158,671.80,1938,5874.50,20141001
CGG_CCX1-AU,161,1075.10,241,3618.10,402,4693.20,20141001
CGG_CCX2-AU,216,1252.80,193,2343.70,409,3596.50,20141001
CGG_CCX3-AU,41,238.35,35,373.70,76,612.05,20141001
CGG_CCX4-AU,40,291.10,39,535.00,79,826.10,20141001
CGG_CCX5-AU,210,2043.85,186,2476.20,396,4520.05,20141001
CGG_CCX6-AU,35,266.55,104,1870.00,139,2136.55,20141001
CGG_CL11-AU,771,1842.20,119,434.30,890,2276.50,20141001
CGG_CLX2-AU,858,1964.30,95,339.95,953,2304.25,20141001
CGG_CPX1-AU,1732,5647.25,301,1647.40,2033,7294.65,20141001
CGG_CPX2-AU,1127,3794.30,227,1156.80,1354,4951.10,20141001
CGG_CS21-AU,893,2831.25,171,962.50,1064,3793.75,20141001
CGG_CS22-AU,683,1620.95,85,291.80,768,1912.75,20141001
CGG_EB29-AU,453,1463.25,82,423.05,535,1886.30,20141001
CGG_EB31-AU,656,1873.30,77,341.85,733,2215.15,20141001
CGG_EB32-AU,812,2096.90,120,558.05,932,2654.95,20141001
CGG_EB33-AU,1149,3031.65,121,563.70,1270,3595.35,20141001
CGG_EB34-AU,370,887.50,29,118.10,399,1005.60,20141001
CGG_EB35-AU,1168,3286.10,140,625.50,1308,3911.60,20141001
CGG_EB36-AU,1116,3062.70,133,634.25,1249,3696.95,20141001
CGG_EB41-AU,803,2523.45,85,452.40,888,2975.85,20141001
CGG_EB42-AU,131,514.05,123,733.50,254,1247.55,20141001
CGG_EB44-AU,128,531.90,149,864.95,277,1396.85,20141001
CGG_EB46-AU,86,354.90,117,695.25,203,1050.15,20141001
CGG_FM21-AU,522,2367.30,250,2711.70,772,5079.00,20141001
CGG_FM22-AU,361,1562.20,272,3276.85,633,4839.05,20141001
CGG_FM23-AU,358,1650.50,281,3616.75,639,5267.25,20141001
CGG_FM24-AU,375,1545.30,268,3421.10,643,4966.40,20141001
CGG_FS21-AU,343,1357.10,125,1313.75,468,2670.85,20141001
CGG_FS22-AU,311,946.35,72,386.15,383,1332.50,20141001
CGG_FS23-AU,175,832.40,133,1824.35,308,2656.75,20141001
CGG_FS24-AU,332,1001.35,85,456.75,417,1458.10,20141001
CGG_FS25-AU,370,1032.85,116,628.05,486,1660.90,20141001
CGG_FS26-AU,359,1156.55,118,693.65,477,1850.20,20141001
CGG_FS31-AU,979,2206.20,75,296.20,1054,2502.40,20141001
CGG_FS32-AU,1067,2457.00,92,352.40,1159,2809.40,20141001
CGG_FS33-AU,1789,3609.20,120,404.80,1909,4014.00,20141001
CGG_GC13-AU,213,1039.10,125,736.60,338,1775.70,20141001
CGG_GH15-AU,215,646.60,52,251.25,267,897.85,20141001
CGG_GH21-AU,514,1020.55,56,190.50,570,1211.05,20141001
CGG_GH23-AU,1107,2000.80,134,450.35,1241,2451.15,20141001
CGG_GH24-AU,1721,3113.80,164,524.75,1885,3638.55,20141001
CGG_GH31-AU,1310,2362.80,149,522.95,1459,2885.75,20141001
CGG_GH32-AU,1233,2348.15,115,361.65,1348,2709.80,20141001
CGG_GH33-AU,785,1942.85,65,316.85,850,2259.70,20141001
CGG_GH34-AU,1217,2824.90,125,405.50,1342,3230.40,20141001
CGG_GH36-AU,1328,3053.90,36,121.85,1364,3175.75,20141001
CGG_GHX1-AU,860,2759.30,223,1226.20,1083,3985.50,20141001
CGG_GHX3-AU,542,1541.65,168,926.15,710,2467.80,20141001
CGG_GHX5-AU,474,1613.95,131,733.70,605,2347.65,20141001
CGG_GM11-AU,138,472.10,67,299.95,205,772.05,20141001
CGG_GM16-AU,148,511.60,41,196.25,189,707.85,20141001
CGG_HAY1-AU,415,3123.50,849,7554.55,1264,10678.05,20141001
CGG_HAY2-AU,406,2850.60,822,7218.25,1228,10068.85,20141001
CGG_HAY3-AU,897,4596.15,556,4746.65,1453,9342.80,20141001
CGG_JSX1-AU,1283,2657.30,132,450.45,1415,3107.75,20141001
CGG_JSX2-AU,1209,2578.50,128,434.95,1337,3013.45,20141001
CGG_LM11-AU,803,1601.30,90,318.05,893,1919.35,20141001
CGG_LM12-AU,801,1286.30,55,189.30,856,1475.60,20141001
CGG_LM13-AU,0,0.00,0,0.00,0,0.00,20141001
CGG_LM14-AU,451,793.85,36,151.85,487,945.70,20141001
CGG_LM15-AU,549,1082.35,73,269.90,622,1352.25,20141001
CGG_LM16-AU,881,1929.15,115,433.05,996,2362.20,20141001
CGG_LM30-AU,1028,1742.55,75,211.10,1103,1953.65,20141001
CGG_LM32-AU,1653,2686.45,95,251.70,1748,2938.15,20141001
CGG_LM41-AU,1114,1885.70,68,185.45,1182,2071.15,20141001
CGG_LM42-AU,1053,1730.35,58,162.30,1111,1892.65,20141001
CGG_LM43-AU,1667,2221.60,68,184.70,1735,2406.30,20141001
CGG_LM44-AU,1904,2956.25,102,303.45,2006,3259.70,20141001
CGG_LMX2-AU,206,1013.55,156,2117.40,362,3130.95,20141001
CGG_LR11-AU,940,1980.80,74,238.10,1014,2218.90,20141001
CGG_LR12-AU,1511,2994.05,88,265.50,1599,3259.55,20141001
CGG_LR13-AU,2550,5195.75,166,516.05,2716,5711.80,20141001
CGG_LR14-AU,1188,2416.25,56,169.35,1244,2585.60,20141001
CGG_LR15-AU,236,997.10,69,404.00,305,1401.10,20141001
CGG_LR16-AU,1096,2478.30,135,485.50,1231,2963.80,20141001
CGG_LR31-AU,312,895.25,91,510.60,403,1405.85,20141001
CGG_LR33-AU,530,1609.70,107,627.45,637,2237.15,20141001
CGG_LR43-AU,797,2214.45,88,345.00,885,2559.45,20141001
CGG_LR47-AU,1161,3586.55,141,713.75,1302,4300.30,20141001
CGG_MB11-AU,836,1812.60,63,198.00,899,2010.60,20141001
CGG_MB12-AU,1179,2490.20,98,344.95,1277,2835.15,20141001
CGG_MB13-AU,922,1823.60,33,98.70,955,1922.30,20141001
CGG_MB14-AU,816,1522.80,30,107.50,846,1630.30,20141001
CGG_MB15-AU,522,957.60,52,167.35,574,1124.95,20141001
CGG_MB16-AU,850,1629.85,70,214.85,920,1844.70,20141001
CGG_MB17-AU,1218,2235.45,110,388.05,1328,2623.50,20141001
CGG_MB23-AU,1582,2597.00,77,228.60,1659,2825.60,20141001
CGG_MB31-AU,2264,3518.25,87,242.95,2351,3761.20,20141001
CGG_MB32-AU,1750,2586.70,91,213.40,1841,2800.10,20141001
CGG_MB33-AU,1869,3048.35,77,233.65,1946,3282.00,20141001
CGG_MB34-AU,1699,2569.45,64,161.60,1763,2731.05,20141001
CGG_MB35-AU,1106,2353.05,107,473.70,1213,2826.75,20141001
CGG_MB36-AU,2204,3279.90,90,282.90,2294,3562.80,20141001
CGG_MB37-AU,935,1610.80,100,364.85,1035,1975.65,20141001
CGG_MB38-AU,1747,2740.15,67,172.25,1814,2912.40,20141001
CGG_MB41-AU,1459,2802.80,86,268.50,1545,3071.30,20141001
CGG_MB42-AU,958,2423.55,49,181.15,1007,2604.70,20141001
CGG_MB44-AU,957,2190.75,57,203.00,1014,2393.75,20141001
CGG_MBX1-AU,1289,3412.05,162,613.65,1451,4025.70,20141001
CGG_MBX2-AU,1102,2827.55,156,598.65,1258,3426.20,20141001
CGG_MBX4-AU,828,2001.35,118,454.90,946,2456.25,20141001
CGG_MC21-AU,1345,3418.15,133,1028.60,1478,4446.75,20141001
CGG_MC22-AU,1675,4263.60,113,689.30,1788,4952.90,20141001
CGG_MC23-AU,839,2086.80,69,372.45,908,2459.25,20141001
CGG_MK31-AU,215,706.90,45,251.25,260,958.15,20141001
CGG_MK34-AU,254,747.15,62,266.85,316,1014.00,20141001
CGG_MK35-AU,119,277.10,29,148.75,148,425.85,20141001
CGG_MM41-AU,1782,3093.00,101,321.10,1883,3414.10,20141001
CGG_MS10-AU,551,1011.70,39,123.65,590,1135.35,20141001
CGG_MS11-AU,1220,2305.55,97,300.45,1317,2606.00,20141001
CGG_MS12-AU,1676,2746.55,151,491.60,1827,3238.15,20141001
CGG_MS21-AU,1298,2333.95,106,361.10,1404,2695.05,20141001
CGG_MS30-AU,674,1119.60,48,118.55,722,1238.15,20141001
CGG_MS31-AU,2094,3963.45,179,575.40,2273,4538.85,20141001
CGG_MS32-AU,1414,2483.95,111,340.40,1525,2824.35,20141001
CGG_MS41-AU,997,1775.20,69,203.00,1066,1978.20,20141001
CGG_MS42-AU,1896,2602.00,114,241.90,2010,2843.90,20141001
CGG_MS43-AU,1926,3291.65,142,414.60,2068,3706.25,20141001
CGG_MS44-AU,1717,2543.05,72,152.15,1789,2695.20,20141001
CGG_MS46-AU,1392,2042.30,52,113.60,1444,2155.90,20141001
CGG_MY21-AU,1071,2219.75,50,156.80,1121,2376.55,20141001
CGG_MY22-AU,1064,2486.00,82,286.75,1146,2772.75,20141001
CGG_MY23-AU,836,1799.60,45,155.55,881,1955.15,20141001
CGG_MY25-AU,1111,2305.80,69,211.75,1180,2517.55,20141001
CGG_MY31-AU,508,1293.30,54,221.20,562,1514.50,20141001
CGG_MY32-AU,680,1656.60,66,243.55,746,1900.15,20141001
CGG_MY33-AU,349,905.50,52,207.40,401,1112.90,20141001
CGG_MY34-AU,420,1299.90,44,188.75,464,1488.65,20141001
CGG_MY35-AU,337,953.35,51,211.25,388,1164.60,20141001
CGG_MY41-AU,1842,4010.20,139,481.05,1981,4491.25,20141001
CGG_MY42-AU,2379,4859.45,164,513.55,2543,5373.00,20141001
CGG_MY43-AU,999,2867.20,75,296.20,1074,3163.40,20141001
CGG_MY44-AU,537,1546.85,60,237.50,597,1784.35,20141001
CGG_MY45-AU,919,2847.10,112,448.70,1031,3295.80,20141001
CGG_MY46-AU,1797,5685.35,182,746.20,1979,6431.55,20141001
CGG_MY47-AU,1312,3989.30,132,518.10,1444,4507.40,20141001
CGG_MY51-AU,1055,3579.80,168,902.50,1223,4482.30,20141001
CGG_MY52-AU,1092,4248.60,228,1660.00,1320,5908.60,20141001
CGG_MY53-AU,645,2310.85,101,569.95,746,2880.80,20141001
CGG_MY54-AU,889,3594.35,212,1534.95,1101,5129.30,20141001
CGG_MY55-AU,1114,4075.25,141,762.50,1255,4837.75,20141001
CGG_MY56-AU,1047,4378.25,272,1978.10,1319,6356.35,20141001
CGG_MY57-AU,1031,3782.45,176,989.35,1207,4771.80,20141001
CGG_PNR1-AU,794,2393.60,240,720.00,1034,3113.60,20141001
CGG_PNR2-AU,136,411.05,15,45.00,151,456.05,20141001
CGG_RBX4-AU,190,587.85,36,146.85,226,734.70,20141001
CGG_RBX5-AU,154,736.70,93,458.75,247,1195.45,20141001
CGG_RBX6-AU,356,1668.75,318,1584.35,674,3253.10,20141001
CGG_RBX7-AU,316,1337.95,245,1215.00,561,2552.95,20141001
CGG_RS11-AU,768,1265.85,49,167.40,817,1433.25,20141001
CGG_RS13-AU,535,815.20,37,143.10,572,958.30,20141001
CGG_RS14-AU,1566,1880.00,47,118.50,1613,1998.50,20141001
CGG_RS15-AU,700,1331.60,91,350.50,791,1682.10,20141001
CGG_RS16-AU,1390,2210.85,63,183.65,1453,2394.50,20141001
CGG_RS20-AU,1450,2280.50,87,246.65,1537,2527.15,20141001
CGG_RS21-AU,1529,2632.30,119,340.30,1648,2972.60,20141001
CGG_RS22-AU,2442,3763.65,129,353.40,2571,4117.05,20141001
CGG_RS23-AU,1675,2859.30,139,378.40,1814,3237.70,20141001
CGG_RS30-AU,1445,2720.60,95,286.65,1540,3007.25,20141001
CGG_RS31-AU,1621,3169.15,128,437.95,1749,3607.10,20141001
CGG_RS32-AU,1210,2345.45,89,296.70,1299,2642.15,20141001
CGG_RS33-AU,1135,2204.55,118,422.30,1253,2626.85,20141001
CGG_RS41-AU,1292,2655.10,115,384.75,1407,3039.85,20141001
CGG_RS42-AU,1367,3084.10,130,479.95,1497,3564.05,20141001
CGG_RS43-AU,712,1416.90,83,274.30,795,1691.20,20141001
CGG_RS44-AU,599,1399.00,51,166.20,650,1565.20,20141001
CGG_RS45-AU,1516,3103.70,121,423.55,1637,3527.25,20141001
CGG_RS46-AU,855,2104.90,73,256.20,928,2361.10,20141001
CGG_RS50-AU,487,1019.75,31,77.50,518,1097.25,20141001
CGG_RS53-AU,902,2327.60,95,344.35,997,2671.95,20141001
CGG_RSX1-AU,497,726.15,14,47.45,511,773.60,20141001
CGG_RSX2-AU,625,1162.15,25,83.65,650,1245.80,20141001
CGG_RSX3-AU,541,1178.80,50,203.10,591,1381.90,20141001
CGG_RT12-AU,1214,3210.10,119,625.45,1333,3835.55,20141001
CGG_SS31-AU,641,1341.30,33,121.20,674,1462.50,20141001
CGG_SS32-AU,534,1062.40,26,116.20,560,1178.60,20141001
CGG_SW30-AU,312,1069.75,65,603.10,377,1672.85,20141001
CGG_SW31-AU,867,2530.95,105,449.35,972,2980.30,20141001
CGG_SW32-AU,291,1015.95,117,1459.35,408,2475.30,20141001
CGG_SW33-AU,519,1513.00,78,324.95,597,1837.95,20141001
CGG_SW34-AU,399,1705.05,203,2640.60,602,4345.65,20141001
CGG_SW35-AU,794,2421.20,103,421.15,897,2842.35,20141001
CGG_TM10-AU,1746,4868.10,403,1849.30,2149,6717.40,20141001
CGG_TMX3-AU,1064,3776.60,265,1901.10,1329,5677.70,20141001
CGG_TMX4-AU,1441,4871.75,320,2199.35,1761,7071.10,20141001
CGG_TMX5-AU,1530,5108.55,559,4271.70,2089,9380.25,20141001
CGG_TMX6-AU,1465,5165.75,429,3023.05,1894,8188.80,20141001
CGG_TMX7-AU,1258,3693.25,375,1714.85,1633,5408.10,20141001
CGG_TMX8-AU,1878,5509.05,1174,5502.05,3052,11011.10,20141001
CGG_TMX9-AU,2132,5678.60,482,2167.90,2614,7846.50,20141001
CGG_TPX1-AU,944,2018.85,122,448.05,1066,2466.90,20141001
CGG_US10-AU,1168,2175.70,87,256.85,1255,2432.55,20141001
CGG_WES1-AU,365,1663.05,129,991.20,494,2654.25,20141001
CGG_WES2-AU,658,2810.35,190,1327.40,848,4137.75,20141001
CGG_YA11-AU,812,1545.60,41,126.15,853,1671.75,20141001
CGG_YA13-AU,1877,3523.10,130,362.30,2007,3885.40,20141001
CGG_YA14-AU,1429,2723.50,64,213.10,1493,2936.60,20141001
CGG_YA18-AU,1079,2096.55,87,270.45,1166,2367.00,20141001
CGG_YA20-AU,1564,3194.15,151,546.15,1715,3740.30,20141001
CGG_YA21-AU,1173,2028.15,75,220.60,1248,2248.75,20141001
CGG_YA23-AU,888,1830.35,64,236.20,952,2066.55,20141001
CGG_YA31-AU,1587,3675.55,135,462.35,1722,4137.90,20141001
CGG_YA32-AU,1056,2441.55,69,240.55,1125,2682.10,20141001
CGG_YA34-AU,977,2655.25,106,473.65,1083,3128.90,20141001
CGG_YA35-AU,953,3036.25,120,646.80,1073,3683.05,20141001
CGG_YA36-AU,652,1937.50,85,451.80,737,2389.30,20141001
CGG_YAX1-AU,761,2167.70,106,499.95,867,2667.65,20141001
CGG_YAX2-AU,658,1911.35,68,285.00,726,2196.35,20141001
CGG_YAX3-AU,282,862.05,51,243.70,333,1105.75,20141001
CGG_YAX4-AU,345,991.95,45,223.70,390,1215.65,20141001
CGG_YCX1-AU,447,1162.65,76,465.60,523,1628.25,20141001
CGG_AP21-AU,494,1236.05,58,240.00,552,1476.05,20140901
CGG_BC21-AU,272,1201.05,161,1952.50,433,3153.55,20140901
CGG_BC41-AU,392,1683.50,249,1451.85,641,3135.35,20140901
CGG_BC42-AU,138,690.90,49,282.85,187,973.75,20140901
CGG_BC43-AU,234,1054.65,299,1752.75,533,2807.40,20140901
CGG_BR22-AU,529,1322.55,109,426.85,638,1749.40,20140901
CGG_BR23-AU,669,1941.65,208,1214.95,877,3156.60,20140901
CGG_BR26-AU,764,1814.80,120,441.80,884,2256.60,20140901
CGG_BR31-AU,807,2196.25,85,420.00,892,2616.25,20140901
CGG_BR32-AU,751,1691.35,35,130.00,786,1821.35,20140901
CGG_BR33-AU,815,2126.65,91,436.80,906,2563.45,20140901
CGG_BR34-AU,1522,2971.55,92,292.95,1614,3264.50,20140901
CGG_BR35-AU,44,109.70,1,5.00,45,114.70,20140901
CGG_BR41-AU,65,305.15,36,216.00,101,521.15,20140901
CGG_BR42-AU,631,1628.00,126,541.15,757,2169.15,20140901
CGG_BR43-AU,66,302.35,68,385.95,134,688.30,20140901
CGG_BR44-AU,276,773.00,36,155.60,312,928.60,20140901
CGG_BR45-AU,83,444.55,103,605.85,186,1050.40,20140901
CGG_BS11-AU,162,855.00,244,1451.85,406,2306.85,20140901
CGG_BS12-AU,305,868.70,50,271.25,355,1139.95,20140901
CGG_BS13-AU,134,749.80,81,486.00,215,1235.80,20140901
CGG_BS16-AU,96,538.30,133,775.10,229,1313.40,20140901
CGG_BS17-AU,486,1414.95,57,545.60,543,1960.55,20140901
CGG_BS18-AU,474,1334.10,69,335.70,543,1669.80,20140901
CGG_BS21-AU,1314,2941.25,73,274.30,1387,3215.55,20140901
CGG_BS22-AU,931,1800.40,44,149.95,975,1950.35,20140901
CGG_BS23-AU,1047,2365.80,106,353.05,1153,2718.85,20140901
CGG_BS24-AU,1126,2313.60,94,288.65,1220,2602.25,20140901
CGG_BS25-AU,1316,3264.50,116,402.95,1432,3667.45,20140901
CGG_BS26-AU,1888,4402.95,152,566.80,2040,4969.75,20140901
CGG_BS27-AU,2186,5877.20,192,703.05,2378,6580.25,20140901
CGG_BS29-AU,888,2529.55,78,306.85,966,2836.40,20140901
CGG_BS31-AU,740,2057.65,67,278.75,807,2336.40,20140901
CGG_BS32-AU,1118,3101.05,96,384.35,1214,3485.40,20140901
CGG_BS34-AU,125,363.00,5,14.35,130,377.35,20140901
CGG_BS35-AU,664,1915.15,59,253.75,723,2168.90,20140901
CGG_BS36-AU,1871,5467.80,170,696.85,2041,6164.65,20140901
CGG_BS37-AU,1813,5219.80,154,619.90,1967,5839.70,20140901
CGG_CCX1-AU,155,1119.15,191,2788.10,346,3907.25,20140901
CGG_CCX2-AU,259,1738.10,178,2465.60,437,4203.70,20140901
CGG_CCX3-AU,44,271.30,47,529.90,91,801.20,20140901
CGG_CCX4-AU,42,268.05,39,493.10,81,761.15,20140901
CGG_CCX5-AU,222,2145.70,178,2335.50,400,4481.20,20140901
CGG_CCX6-AU,45,348.05,86,1392.50,131,1740.55,20140901
CGG_CL11-AU,782,1949.75,124,437.50,906,2387.25,20140901
CGG_CLX2-AU,857,1939.00,67,231.80,924,2170.80,20140901
CGG_CPX1-AU,1771,5879.85,248,1237.45,2019,7117.30,20140901
CGG_CPX2-AU,1089,3546.00,185,928.10,1274,4474.10,20140901
CGG_CS21-AU,822,2748.95,197,1071.75,1019,3820.70,20140901
CGG_CS22-AU,674,1528.85,91,328.70,765,1857.55,20140901
CGG_EB29-AU,422,1245.40,54,272.50,476,1517.90,20140901
CGG_EB31-AU,637,1793.90,99,441.25,736,2235.15,20140901
CGG_EB32-AU,903,2352.35,83,408.10,986,2760.45,20140901
CGG_EB33-AU,978,2708.10,99,447.50,1077,3155.60,20140901
CGG_EB34-AU,393,862.35,38,166.25,431,1028.60,20140901
CGG_EB35-AU,1002,2884.50,99,432.45,1101,3316.95,20140901
CGG_EB36-AU,1228,3440.40,142,654.35,1370,4094.75,20140901
CGG_EB41-AU,666,2245.70,98,616.20,764,2861.90,20140901
CGG_EB42-AU,143,653.65,89,527.25,232,1180.90,20140901
CGG_EB44-AU,91,466.38,122,723.25,213,1189.63,20140901
CGG_EB46-AU,67,332.60,131,776.00,198,1108.60,20140901
CGG_FM21-AU,552,2241.75,229,2737.45,781,4979.20,20140901
CGG_FM22-AU,444,2053.55,271,3151.80,715,5205.35,20140901
CGG_FM23-AU,370,1674.45,288,3739.35,658,5413.80,20140901
CGG_FM24-AU,322,1528.10,191,2668.75,513,4196.85,20140901
CGG_FS21-AU,308,1234.45,112,1165.60,420,2400.05,20140901
CGG_FS22-AU,474,1560.35,86,458.05,560,2018.40,20140901
CGG_FS23-AU,181,857.00,120,1501.25,301,2358.25,20140901
CGG_FS24-AU,51,160.45,13,61.85,64,222.30,20140901
CGG_FS25-AU,385,1178.70,96,530.60,481,1709.30,20140901
CGG_FS26-AU,348,1072.85,87,531.25,435,1604.10,20140901
CGG_FS31-AU,919,1970.05,85,312.45,1004,2282.50,20140901
CGG_FS32-AU,974,2289.10,142,597.40,1116,2886.50,20140901
CGG_FS33-AU,1881,3807.20,98,322.40,1979,4129.60,20140901
CGG_GC13-AU,231,1104.70,107,627.85,338,1732.55,20140901
CGG_GH15-AU,224,667.25,56,254.35,280,921.60,20140901
CGG_GH21-AU,484,950.00,42,129.35,526,1079.35,20140901
CGG_GH23-AU,1150,2078.45,98,319.30,1248,2397.75,20140901
CGG_GH24-AU,1768,3291.40,167,561.75,1935,3853.15,20140901
CGG_GH31-AU,1386,2519.50,108,383.55,1494,2903.05,20140901
CGG_GH32-AU,1106,2158.20,116,401.85,1222,2560.05,20140901
CGG_GH33-AU,757,1763.35,55,256.15,812,2019.50,20140901
CGG_GH34-AU,1082,2496.20,68,248.70,1150,2744.90,20140901
CGG_GH36-AU,1222,2779.50,65,229.25,1287,3008.75,20140901
CGG_GHX1-AU,1010,3554.75,280,1573.65,1290,5128.40,20140901
CGG_GHX3-AU,664,2272.40,218,1192.95,882,3465.35,20140901
CGG_GHX5-AU,618,2147.40,204,1157.45,822,3304.85,20140901
CGG_GM11-AU,155,560.85,54,248.75,209,809.60,20140901
CGG_GM16-AU,167,515.90,38,155.00,205,670.90,20140901
CGG_HAY1-AU,450,3433.60,831,7397.85,1281,10831.45,20140901
CGG_HAY2-AU,381,2831.65,737,6476.85,1118,9308.50,20140901
CGG_HAY3-AU,701,3618.50,524,4552.75,1225,8171.25,20140901
CGG_JSX1-AU,1154,2611.00,104,351.75,1258,2962.75,20140901
CGG_JSX2-AU,1385,2855.60,123,429.90,1508,3285.50,20140901
CGG_LM11-AU,719,1495.40,95,367.40,814,1862.80,20140901
CGG_LM12-AU,828,1420.35,64,223.70,892,1644.05,20140901
CGG_LM13-AU,0,0.00,0,0.00,0,0.00,20140901
CGG_LM14-AU,389,679.25,29,116.25,418,795.50,20140901
CGG_LM15-AU,499,1001.15,53,206.20,552,1207.35,20140901
CGG_LM16-AU,877,1878.80,95,383.70,972,2262.50,20140901
CGG_LM30-AU,1081,1786.75,63,172.50,1144,1959.25,20140901
CGG_LM32-AU,1664,2598.65,93,261.10,1757,2859.75,20140901
CGG_LM41-AU,1124,1822.40,36,86.05,1160,1908.45,20140901
CGG_LM42-AU,1054,1701.60,43,124.90,1097,1826.50,20140901
CGG_LM43-AU,1660,2047.50,81,205.35,1741,2252.85,20140901
CGG_LM44-AU,1901,2830.00,94,306.10,1995,3136.10,20140901
CGG_LMX2-AU,198,1032.15,153,1925.55,351,2957.70,20140901
CGG_LR11-AU,968,1977.65,54,183.10,1022,2160.75,20140901
CGG_LR12-AU,1496,2949.05,85,251.10,1581,3200.15,20140901
CGG_LR13-AU,2522,5179.15,127,423.10,2649,5602.25,20140901
CGG_LR14-AU,1152,2280.35,74,227.95,1226,2508.30,20140901
CGG_LR15-AU,210,891.30,79,449.75,289,1341.05,20140901
CGG_LR16-AU,1073,2492.15,125,442.45,1198,2934.60,20140901
CGG_LR31-AU,321,914.40,55,266.25,376,1180.65,20140901
CGG_LR33-AU,532,1534.40,89,549.35,621,2083.75,20140901
CGG_LR43-AU,857,2351.90,61,246.20,918,2598.10,20140901
CGG_LR47-AU,1240,3769.25,130,597.45,1370,4366.70,20140901
CGG_MB11-AU,842,1784.40,65,218.10,907,2002.50,20140901
CGG_MB12-AU,1257,2566.05,83,276.80,1340,2842.85,20140901
CGG_MB13-AU,766,1633.20,33,103.70,799,1736.90,20140901
CGG_MB14-AU,864,1635.10,42,144.95,906,1780.05,20140901
CGG_MB15-AU,581,1023.10,52,191.80,633,1214.90,20140901
CGG_MB16-AU,865,1519.10,49,168.05,914,1687.15,20140901
CGG_MB17-AU,1148,2123.90,108,364.25,1256,2488.15,20140901
CGG_MB23-AU,1543,2489.60,68,175.50,1611,2665.10,20140901
CGG_MB31-AU,2167,3304.85,98,267.80,2265,3572.65,20140901
CGG_MB32-AU,1675,2442.90,69,171.60,1744,2614.50,20140901
CGG_MB33-AU,1747,2925.25,95,251.50,1842,3176.75,20140901
CGG_MB34-AU,1536,2307.65,65,171.05,1601,2478.70,20140901
CGG_MB35-AU,1041,2138.60,129,513.10,1170,2651.70,20140901
CGG_MB36-AU,2075,3181.75,95,319.85,2170,3501.60,20140901
CGG_MB37-AU,904,1602.10,80,298.05,984,1900.15,20140901
CGG_MB38-AU,1722,2668.80,50,144.20,1772,2813.00,20140901
CGG_MB41-AU,1444,2635.30,68,221.15,1512,2856.45,20140901
CGG_MB42-AU,907,2254.20,61,203.05,968,2457.25,20140901
CGG_MB44-AU,1023,2225.05,58,193.65,1081,2418.70,20140901
CGG_MBX1-AU,1248,3243.30,157,584.90,1405,3828.20,20140901
CGG_MBX2-AU,1094,2813.20,157,578.70,1251,3391.90,20140901
CGG_MBX4-AU,816,1994.35,96,383.70,912,2378.05,20140901
CGG_MC21-AU,1516,3930.25,135,926.80,1651,4857.05,20140901
CGG_MC22-AU,1546,3848.45,136,744.25,1682,4592.70,20140901
CGG_MC23-AU,813,2132.80,73,419.35,886,2552.15,20140901
CGG_MK31-AU,218,729.40,28,149.95,246,879.35,20140901
CGG_MK34-AU,223,630.60,65,309.95,288,940.55,20140901
CGG_MK35-AU,101,263.85,22,110.00,123,373.85,20140901
CGG_MM41-AU,1900,3308.90,109,304.05,2009,3612.95,20140901
CGG_MS10-AU,481,852.15,56,155.50,537,1007.65,20140901
CGG_MS11-AU,1225,2269.40,87,286.10,1312,2555.50,20140901
CGG_MS12-AU,1649,2765.75,115,419.80,1764,3185.55,20140901
CGG_MS21-AU,1422,2643.45,108,343.55,1530,2987.00,20140901
CGG_MS30-AU,707,1155.80,52,128.00,759,1283.80,20140901
CGG_MS31-AU,2280,4335.10,180,579.00,2460,4914.10,20140901
CGG_MS32-AU,1477,2587.15,110,301.10,1587,2888.25,20140901
CGG_MS41-AU,1055,1806.65,76,217.35,1131,2024.00,20140901
CGG_MS42-AU,2007,2650.95,103,213.80,2110,2864.75,20140901
CGG_MS43-AU,1673,2880.65,123,362.80,1796,3243.45,20140901
CGG_MS44-AU,1457,2158.70,76,176.00,1533,2334.70,20140901
CGG_MS46-AU,1347,1984.65,52,109.80,1399,2094.45,20140901
CGG_MY21-AU,1045,2178.95,9,29.95,1054,2208.90,20140901
CGG_MY22-AU,976,2330.30,54,166.85,1030,2497.15,20140901
CGG_MY23-AU,866,1813.15,49,164.35,915,1977.50,20140901
CGG_MY25-AU,1094,2283.25,58,193.65,1152,2476.90,20140901
CGG_MY31-AU,568,1359.10,65,261.80,633,1620.90,20140901
CGG_MY32-AU,695,1626.65,48,171.15,743,1797.80,20140901
CGG_MY33-AU,347,943.95,53,209.35,400,1153.30,20140901
CGG_MY34-AU,405,1195.50,37,160.60,442,1356.10,20140901
CGG_MY35-AU,343,971.25,39,161.85,382,1133.10,20140901
CGG_MY41-AU,1790,3880.05,126,411.75,1916,4291.80,20140901
CGG_MY42-AU,2581,5102.15,148,427.30,2729,5529.45,20140901
CGG_MY43-AU,954,2788.00,76,283.70,1030,3071.70,20140901
CGG_MY44-AU,498,1517.20,35,138.75,533,1655.95,20140901
CGG_MY45-AU,908,2839.60,96,388.75,1004,3228.35,20140901
CGG_MY46-AU,1805,5722.00,173,706.20,1978,6428.20,20140901
CGG_MY47-AU,1335,4069.25,98,391.25,1433,4460.50,20140901
CGG_MY51-AU,954,3309.45,144,825.60,1098,4135.05,20140901
CGG_MY52-AU,1099,4119.45,212,1511.85,1311,5631.30,20140901
CGG_MY53-AU,726,2652.15,97,488.10,823,3140.25,20140901
CGG_MY54-AU,906,3794.85,198,1508.70,1104,5303.55,20140901
CGG_MY55-AU,1077,3817.70,203,1094.30,1280,4912.00,20140901
CGG_MY56-AU,1053,4614.95,236,1749.30,1289,6364.25,20140901
CGG_MY57-AU,1126,4088.25,156,882.50,1282,4970.75,20140901
CGG_PNR1-AU,827,2498.70,246,738.00,1073,3236.70,20140901
CGG_PNR2-AU,103,310.60,8,24.00,111,334.60,20140901
CGG_RBX4-AU,258,791.10,45,194.95,303,986.05,20140901
CGG_RBX5-AU,211,829.90,93,461.25,304,1291.15,20140901
CGG_RBX6-AU,390,1849.85,297,1478.75,687,3328.60,20140901
CGG_RBX7-AU,251,1172.05,239,1178.75,490,2350.80,20140901
CGG_RS11-AU,700,1144.05,44,149.95,744,1294.00,20140901
CGG_RS13-AU,571,880.80,42,159.95,613,1040.75,20140901
CGG_RS14-AU,1472,1730.60,54,150.35,1526,1880.95,20140901
CGG_RS15-AU,665,1232.60,93,345.55,758,1578.15,20140901
CGG_RS16-AU,1416,2235.65,66,218.70,1482,2454.35,20140901
CGG_RS20-AU,1323,2055.35,82,254.80,1405,2310.15,20140901
CGG_RS21-AU,1365,2241.30,120,415.45,1485,2656.75,20140901
CGG_RS22-AU,2346,3587.30,125,361.65,2471,3948.95,20140901
CGG_RS23-AU,1577,2597.35,104,323.00,1681,2920.35,20140901
CGG_RS30-AU,1444,2406.30,92,274.75,1536,2681.05,20140901
CGG_RS31-AU,1508,2799.45,109,332.30,1617,3131.75,20140901
CGG_RS32-AU,1148,2280.80,87,309.85,1235,2590.65,20140901
CGG_RS33-AU,1113,2179.80,103,374.30,1216,2554.10,20140901
CGG_RS41-AU,1334,2602.35,133,440.30,1467,3042.65,20140901
CGG_RS42-AU,1367,3174.60,92,355.55,1459,3530.15,20140901
CGG_RS43-AU,706,1464.90,80,262.40,786,1727.30,20140901
CGG_RS44-AU,534,1237.65,40,144.35,574,1382.00,20140901
CGG_RS45-AU,1406,2935.85,131,458.05,1537,3393.90,20140901
CGG_RS46-AU,803,2056.00,83,304.35,886,2360.35,20140901
CGG_RS50-AU,407,848.20,24,56.85,431,905.05,20140901
CGG_RS53-AU,847,2148.90,86,342.50,933,2491.40,20140901
CGG_RSX1-AU,454,595.10,13,36.20,467,631.30,20140901
CGG_RSX2-AU,649,1212.60,30,101.15,679,1313.75,20140901
CGG_RSX3-AU,481,1048.65,40,155.00,521,1203.65,20140901
CGG_RT12-AU,1188,3194.05,131,703.65,1319,3897.70,20140901
CGG_SS31-AU,641,1424.30,39,201.25,680,1625.55,20140901
CGG_SS32-AU,512,1082.05,21,90.00,533,1172.05,20140901
CGG_SW30-AU,312,1094.48,76,740.60,388,1835.08,20140901
CGG_SW31-AU,972,2729.70,96,388.10,1068,3117.80,20140901
CGG_SW32-AU,335,1192.50,105,1241.25,440,2433.75,20140901
CGG_SW33-AU,511,1449.30,75,293.70,586,1743.00,20140901
CGG_SW34-AU,453,1961.10,164,2013.10,617,3974.20,20140901
CGG_SW35-AU,867,2628.60,95,398.10,962,3026.70,20140901
CGG_TM10-AU,1740,5121.20,367,1683.65,2107,6804.85,20140901
CGG_TMX3-AU,910,3369.40,255,1899.95,1165,5269.35,20140901
CGG_TMX4-AU,1413,4707.65,318,2205.55,1731,6913.20,20140901
CGG_TMX5-AU,1485,4912.95,522,3797.35,2007,8710.30,20140901
CGG_TMX6-AU,1560,5492.65,433,2998.60,1993,8491.25,20140901
CGG_TMX7-AU,1226,3581.35,352,1621.80,1578,5203.15,20140901
CGG_TMX8-AU,1870,5557.15,1127,5348.00,2997,10905.15,20140901
CGG_TMX9-AU,2044,5459.05,447,2014.30,2491,7473.35,20140901
CGG_TPX1-AU,927,2006.90,174,684.90,1101,2691.80,20140901
CGG_US10-AU,1198,2252.65,75,249.90,1273,2502.55,20140901
CGG_WES1-AU,329,1554.90,80,590.00,409,2144.90,20140901
CGG_WES2-AU,614,2698.60,149,1028.10,763,3726.70,20140901
CGG_YA11-AU,787,1527.60,47,128.00,834,1655.60,20140901
CGG_YA13-AU,1838,3439.95,122,337.30,1960,3777.25,20140901
CGG_YA14-AU,1527,2731.60,81,196.00,1608,2927.60,20140901
CGG_YA18-AU,1126,2200.05,74,196.10,1200,2396.15,20140901
CGG_YA20-AU,1514,3145.25,131,438.65,1645,3583.90,20140901
CGG_YA21-AU,1115,2038.00,74,203.65,1189,2241.65,20140901
CGG_YA23-AU,958,1905.55,77,249.25,1035,2154.80,20140901
CGG_YA31-AU,1567,3712.80,133,449.20,1700,4162.00,20140901
CGG_YA32-AU,1097,2434.40,62,191.70,1159,2626.10,20140901
CGG_YA34-AU,885,2288.40,74,361.85,959,2650.25,20140901
CGG_YA35-AU,908,2831.50,111,576.25,1019,3407.75,20140901
CGG_YA36-AU,678,2135.85,74,360.00,752,2495.85,20140901
CGG_YAX1-AU,719,2139.00,102,493.05,821,2632.05,20140901
CGG_YAX2-AU,631,1836.70,65,268.05,696,2104.75,20140901
CGG_YAX3-AU,234,771.50,27,145.00,261,916.50,20140901
CGG_YAX4-AU,316,943.45,46,208.75,362,1152.20,20140901
CGG_YCX1-AU,336,898.30,60,336.85,396,1235.15,20140901
CGG_AP21-AU,583,1463.85,95,414.95,678,1878.80,20140801
CGG_BC21-AU,224,1031.10,194,2599.30,418,3630.40,20140801
CGG_BC41-AU,406,1766.45,266,1563.35,672,3329.80,20140801
CGG_BC42-AU,188,911.45,82,483.75,270,1395.20,20140801
CGG_BC43-AU,179,768.05,284,1682.00,463,2450.05,20140801
CGG_BR22-AU,439,1058.40,109,434.35,548,1492.75,20140801
CGG_BR23-AU,694,2021.70,189,1071.20,883,3092.90,20140801
CGG_BR26-AU,760,1696.15,117,457.45,877,2153.60,20140801
CGG_BR31-AU,759,2016.50,91,438.10,850,2454.60,20140801
CGG_BR32-AU,728,1524.45,35,108.05,763,1632.50,20140801
CGG_BR33-AU,903,2164.85,87,409.30,990,2574.15,20140801
CGG_BR34-AU,1397,2672.70,79,208.55,1476,2881.25,20140801
CGG_BR35-AU,0,0.00,0,0.00,0,0.00,20140801
CGG_BR41-AU,0,0.00,0,0.00,0,0.00,20140801
CGG_BR42-AU,543,1379.30,126,551.85,669,1931.15,20140801
CGG_BR43-AU,0,0.00,0,0.00,0,0.00,20140801
CGG_BR44-AU,266,724.60,27,123.10,293,847.70,20140801
CGG_BR45-AU,85,439.65,158,942.25,243,1381.90,20140801
CGG_BS11-AU,133,750.70,275,1635.35,408,2386.05,20140801
CGG_BS12-AU,285,840.85,37,189.35,322,1030.20,20140801
CGG_BS13-AU,134,782.30,35,210.00,169,992.30,20140801
CGG_BS16-AU,82,435.10,126,750.60,208,1185.70,20140801
CGG_BS17-AU,468,1358.35,52,408.75,520,1767.10,20140801
CGG_BS18-AU,470,1248.40,93,453.00,563,1701.40,20140801
CGG_BS21-AU,1305,2924.55,74,266.80,1379,3191.35,20140801
CGG_BS22-AU,888,1780.75,48,144.30,936,1925.05,20140801
CGG_BS23-AU,1008,2276.45,83,272.40,1091,2548.85,20140801
CGG_BS24-AU,1082,2314.80,91,306.85,1173,2621.65,20140801
CGG_BS25-AU,1395,3319.80,140,509.95,1535,3829.75,20140801
CGG_BS26-AU,1828,4362.05,144,518.70,1972,4880.75,20140801
CGG_BS27-AU,2070,5451.60,176,684.95,2246,6136.55,20140801
CGG_BS29-AU,830,2456.65,70,283.10,900,2739.75,20140801
CGG_BS31-AU,722,2061.45,56,223.75,778,2285.20,20140801
CGG_BS32-AU,1002,2821.60,105,450.55,1107,3272.15,20140801
CGG_BS34-AU,111,301.30,8,35.00,119,336.30,20140801
CGG_BS35-AU,651,1894.10,41,160.00,692,2054.10,20140801
CGG_BS36-AU,1711,5043.20,173,712.45,1884,5755.65,20140801
CGG_BS37-AU,1743,5006.95,124,506.85,1867,5513.80,20140801
CGG_CCX1-AU,142,983.20,263,4098.70,405,5081.90,20140801
CGG_CCX2-AU,248,1641.75,241,3350.60,489,4992.35,20140801
CGG_CCX3-AU,79,522.15,83,921.00,162,1443.15,20140801
CGG_CCX4-AU,59,389.80,44,557.50,103,947.30,20140801
CGG_CCX5-AU,242,2115.15,338,5246.80,580,7361.95,20140801
CGG_CCX6-AU,48,367.10,109,1847.50,157,2214.60,20140801
CGG_CL11-AU,715,1662.35,107,388.75,822,2051.10,20140801
CGG_CLX2-AU,843,1833.75,71,238.70,914,2072.45,20140801
CGG_CPX1-AU,1219,3923.25,206,1084.30,1425,5007.55,20140801
CGG_CPX2-AU,830,2725.20,201,1074.35,1031,3799.55,20140801
CGG_CS21-AU,746,2490.15,222,1324.90,968,3815.05,20140801
CGG_CS22-AU,690,1645.85,104,398.70,794,2044.55,20140801
CGG_EB29-AU,347,1001.50,44,217.50,391,1219.00,20140801
CGG_EB31-AU,569,1565.15,53,198.10,622,1763.25,20140801
CGG_EB32-AU,664,1720.25,93,431.85,757,2152.10,20140801
CGG_EB33-AU,1293,3476.45,131,591.10,1424,4067.55,20140801
CGG_EB34-AU,967,2191.90,76,292.50,1043,2484.40,20140801
CGG_EB35-AU,882,2599.45,103,512.45,985,3111.90,20140801
CGG_EB36-AU,927,2662.75,127,579.30,1054,3242.05,20140801
CGG_EB41-AU,450,1379.25,76,473.70,526,1852.95,20140801
CGG_EB42-AU,123,603.95,79,466.25,202,1070.20,20140801
CGG_EB44-AU,82,392.80,131,786.00,213,1178.80,20140801
CGG_EB46-AU,70,330.10,136,807.75,206,1137.85,20140801
CGG_FM21-AU,488,2315.65,297,3682.50,785,5998.15,20140801
CGG_FM22-AU,482,2322.15,283,3277.45,765,5599.60,20140801
CGG_FM23-AU,399,1891.85,294,4024.30,693,5916.15,20140801
CGG_FM24-AU,255,1248.10,216,2695.55,471,3943.65,20140801
CGG_FS21-AU,254,1257.80,108,1231.85,362,2489.65,20140801
CGG_FS22-AU,461,1640.55,148,834.30,609,2474.85,20140801
CGG_FS23-AU,155,632.75,133,1797.40,288,2430.15,20140801
CGG_FS24-AU,0,0.00,0,0.00,0,0.00,20140801
CGG_FS25-AU,368,1188.10,131,781.25,499,1969.35,20140801
CGG_FS26-AU,294,1038.50,121,760.00,415,1798.50,20140801
CGG_FS31-AU,894,1991.60,81,301.25,975,2292.85,20140801
CGG_FS32-AU,1159,2766.50,157,647.40,1316,3413.90,20140801
CGG_FS33-AU,1942,3978.95,117,399.20,2059,4378.15,20140801
CGG_GC13-AU,195,959.00,131,774.00,326,1733.00,20140801
CGG_GH15-AU,207,614.00,63,283.75,270,897.75,20140801
CGG_GH21-AU,511,1023.90,30,98.70,541,1122.60,20140801
CGG_GH23-AU,1062,1932.60,107,383.00,1169,2315.60,20140801
CGG_GH24-AU,1609,3153.50,188,650.45,1797,3803.95,20140801
CGG_GH31-AU,1408,2636.55,137,475.50,1545,3112.05,20140801
CGG_GH32-AU,1309,2659.05,127,425.40,1436,3084.45,20140801
CGG_GH33-AU,917,2262.50,87,428.65,1004,2691.15,20140801
CGG_GH34-AU,1107,2574.05,99,355.55,1206,2929.60,20140801
CGG_GH36-AU,1488,3562.90,79,282.45,1567,3845.35,20140801
CGG_GHX1-AU,895,3181.20,323,1887.45,1218,5068.65,20140801
CGG_GHX3-AU,563,1908.90,219,1296.85,782,3205.75,20140801
CGG_GHX5-AU,618,2273.95,215,1267.45,833,3541.40,20140801
CGG_GM11-AU,182,640.85,44,203.10,226,843.95,20140801
CGG_GM16-AU,200,660.70,40,190.00,240,850.70,20140801
CGG_HAY1-AU,490,3519.75,892,7903.55,1382,11423.30,20140801
CGG_HAY2-AU,466,3291.60,723,6385.90,1189,9677.50,20140801
CGG_HAY3-AU,904,4658.10,575,4905.35,1479,9563.45,20140801
CGG_JSX1-AU,1089,2433.45,93,385.55,1182,2819.00,20140801
CGG_JSX2-AU,1170,2558.20,120,453.70,1290,3011.90,20140801
CGG_LM11-AU,817,1717.05,72,257.95,889,1975.00,20140801
CGG_LM12-AU,849,1465.20,75,270.55,924,1735.75,20140801
CGG_LM13-AU,0,0.00,0,0.00,0,0.00,20140801
CGG_LM14-AU,258,419.25,21,78.70,279,497.95,20140801
CGG_LM15-AU,599,1359.35,39,146.20,638,1505.55,20140801
CGG_LM16-AU,842,1897.70,140,537.40,982,2435.10,20140801
CGG_LM30-AU,1015,1682.05,78,212.90,1093,1894.95,20140801
CGG_LM32-AU,1522,2372.20,82,221.05,1604,2593.25,20140801
CGG_LM41-AU,1045,1682.70,60,173.05,1105,1855.75,20140801
CGG_LM42-AU,976,1632.65,62,186.05,1038,1818.70,20140801
CGG_LM43-AU,1523,2057.85,57,139.15,1580,2197.00,20140801
CGG_LM44-AU,1751,2719.80,105,325.90,1856,3045.70,20140801
CGG_LMX2-AU,235,1191.60,183,2281.25,418,3472.85,20140801
CGG_LR11-AU,945,1950.95,48,154.90,993,2105.85,20140801
CGG_LR12-AU,1473,2910.85,75,218.70,1548,3129.55,20140801
CGG_LR13-AU,2422,4882.65,168,549.15,2590,5431.80,20140801
CGG_LR14-AU,1069,2074.25,60,179.90,1129,2254.15,20140801
CGG_LR15-AU,234,965.35,69,397.75,303,1363.10,20140801
CGG_LR16-AU,1068,2355.05,150,564.35,1218,2919.40,20140801
CGG_LR31-AU,311,857.80,71,377.50,382,1235.30,20140801
CGG_LR33-AU,481,1284.05,107,631.20,588,1915.25,20140801
CGG_LR43-AU,756,2091.85,81,316.75,837,2408.60,20140801
CGG_LR47-AU,1099,3432.80,139,671.15,1238,4103.95,20140801
CGG_MB11-AU,784,1639.15,46,151.20,830,1790.35,20140801
CGG_MB12-AU,1171,2429.20,116,398.00,1287,2827.20,20140801
CGG_MB13-AU,761,1462.65,39,123.05,800,1585.70,20140801
CGG_MB14-AU,780,1455.15,47,148.00,827,1603.15,20140801
CGG_MB15-AU,532,989.35,59,204.25,591,1193.60,20140801
CGG_MB16-AU,774,1400.25,60,203.70,834,1603.95,20140801
CGG_MB17-AU,1109,1888.75,117,423.60,1226,2312.35,20140801
CGG_MB23-AU,1344,2217.95,66,204.80,1410,2422.75,20140801
CGG_MB31-AU,1979,2975.80,88,217.15,2067,3192.95,20140801
CGG_MB32-AU,1533,2227.35,73,183.45,1606,2410.80,20140801
CGG_MB33-AU,1571,2562.95,89,275.40,1660,2838.35,20140801
CGG_MB34-AU,1476,2112.70,58,142.95,1534,2255.65,20140801
CGG_MB35-AU,987,2077.80,117,501.20,1104,2579.00,20140801
CGG_MB36-AU,1985,2979.60,124,361.50,2109,3341.10,20140801
CGG_MB37-AU,877,1562.10,89,334.85,966,1896.95,20140801
CGG_MB38-AU,1703,2801.20,80,199.80,1783,3001.00,20140801
CGG_MB41-AU,1515,2694.60,92,287.80,1607,2982.40,20140801
CGG_MB42-AU,956,2178.35,60,201.80,1016,2380.15,20140801
CGG_MB44-AU,1084,2253.80,65,272.50,1149,2526.30,20140801
CGG_MBX1-AU,1032,2618.40,111,429.30,1143,3047.70,20140801
CGG_MBX2-AU,1029,2591.90,115,418.05,1144,3009.95,20140801
CGG_MBX4-AU,791,1907.35,77,302.45,868,2209.80,20140801
CGG_MC21-AU,1289,3307.90,144,951.00,1433,4258.90,20140801
CGG_MC22-AU,1439,3666.55,136,768.60,1575,4435.15,20140801
CGG_MC23-AU,967,2444.25,80,378.10,1047,2822.35,20140801
CGG_MK31-AU,181,656.05,20,116.25,201,772.30,20140801
CGG_MK34-AU,185,535.55,36,181.25,221,716.80,20140801
CGG_MK35-AU,123,339.45,23,139.35,146,478.80,20140801
CGG_MM41-AU,1870,3166.80,100,270.50,1970,3437.30,20140801
CGG_MS10-AU,559,977.45,33,105.60,592,1083.05,20140801
CGG_MS11-AU,1125,2124.35,94,313.00,1219,2437.35,20140801
CGG_MS12-AU,1549,2594.40,106,346.65,1655,2941.05,20140801
CGG_MS21-AU,1572,2726.00,100,327.95,1672,3053.95,20140801
CGG_MS30-AU,722,1210.75,53,171.80,775,1382.55,20140801
CGG_MS31-AU,1937,3638.35,192,629.75,2129,4268.10,20140801
CGG_MS32-AU,1375,2288.85,110,322.30,1485,2611.15,20140801
CGG_MS41-AU,996,1680.25,53,144.30,1049,1824.55,20140801
CGG_MS42-AU,1877,2446.45,109,229.45,1986,2675.90,20140801
CGG_MS43-AU,1652,2764.25,121,366.60,1773,3130.85,20140801
CGG_MS44-AU,1510,2144.45,70,137.75,1580,2282.20,20140801
CGG_MS46-AU,1318,1843.10,59,133.55,1377,1976.65,20140801
CGG_MY21-AU,980,2092.65,12,39.35,992,2132.00,20140801
CGG_MY22-AU,1013,2373.35,79,276.80,1092,2650.15,20140801
CGG_MY23-AU,866,1959.70,58,199.95,924,2159.65,20140801
CGG_MY25-AU,1073,2287.40,79,249.30,1152,2536.70,20140801
CGG_MY31-AU,564,1368.00,66,257.45,630,1625.45,20140801
CGG_MY32-AU,772,1891.60,77,319.30,849,2210.90,20140801
CGG_MY33-AU,335,988.30,51,219.35,386,1207.65,20140801
CGG_MY34-AU,473,1431.10,51,206.25,524,1637.35,20140801
CGG_MY35-AU,318,916.35,36,152.50,354,1068.85,20140801
CGG_MY41-AU,1837,4131.15,153,504.90,1990,4636.05,20140801
CGG_MY42-AU,2417,5018.60,143,444.10,2560,5462.70,20140801
CGG_MY43-AU,948,2757.50,67,261.20,1015,3018.70,20140801
CGG_MY44-AU,548,1599.75,37,148.75,585,1748.50,20140801
CGG_MY45-AU,943,2937.00,137,541.85,1080,3478.85,20140801
CGG_MY46-AU,1751,5509.95,166,673.05,1917,6183.00,20140801
CGG_MY47-AU,1265,3851.65,98,393.10,1363,4244.75,20140801
CGG_MY51-AU,948,3186.15,132,739.35,1080,3925.50,20140801
CGG_MY52-AU,1027,3710.00,229,1691.85,1256,5401.85,20140801
CGG_MY53-AU,571,1954.15,94,491.85,665,2446.00,20140801
CGG_MY54-AU,935,3698.70,187,1399.35,1122,5098.05,20140801
CGG_MY55-AU,1107,4004.90,182,1014.90,1289,5019.80,20140801
CGG_MY56-AU,1050,4315.30,252,1918.10,1302,6233.40,20140801
CGG_MY57-AU,1004,3780.25,185,1069.35,1189,4849.60,20140801
CGG_PNR1-AU,730,2201.10,257,771.00,987,2972.10,20140801
CGG_PNR2-AU,121,367.40,11,33.00,132,400.40,20140801
CGG_RBX4-AU,122,342.50,16,71.25,138,413.75,20140801
CGG_RBX5-AU,108,495.35,65,325.00,173,820.35,20140801
CGG_RBX6-AU,356,1732.85,285,1422.50,641,3155.35,20140801
CGG_RBX7-AU,243,1119.60,202,1006.25,445,2125.85,20140801
CGG_RS11-AU,705,1196.40,47,183.05,752,1379.45,20140801
CGG_RS13-AU,520,821.25,48,191.20,568,1012.45,20140801
CGG_RS14-AU,1471,1830.55,52,146.10,1523,1976.65,20140801
CGG_RS15-AU,655,1257.15,90,348.75,745,1605.90,20140801
CGG_RS16-AU,1363,2214.50,72,213.65,1435,2428.15,20140801
CGG_RS20-AU,1356,2114.10,81,239.25,1437,2353.35,20140801
CGG_RS21-AU,1457,2440.15,100,312.95,1557,2753.10,20140801
CGG_RS22-AU,2067,3112.95,123,365.90,2190,3478.85,20140801
CGG_RS23-AU,1538,2559.70,103,300.35,1641,2860.05,20140801
CGG_RS30-AU,1329,2237.85,81,234.85,1410,2472.70,20140801
CGG_RS31-AU,1492,2801.80,79,256.80,1571,3058.60,20140801
CGG_RS32-AU,1074,2109.80,79,251.80,1153,2361.60,20140801
CGG_RS33-AU,972,1911.75,108,360.40,1080,2272.15,20140801
CGG_RS41-AU,1260,2548.75,117,412.40,1377,2961.15,20140801
CGG_RS42-AU,1348,3150.95,117,427.40,1465,3578.35,20140801
CGG_RS43-AU,729,1486.80,71,239.30,800,1726.10,20140801
CGG_RS44-AU,540,1181.60,59,219.35,599,1400.95,20140801
CGG_RS45-AU,1375,2896.10,135,441.10,1510,3337.20,20140801
CGG_RS46-AU,781,1916.20,88,344.35,869,2260.55,20140801
CGG_RS50-AU,487,1037.50,32,68.70,519,1106.20,20140801
CGG_RS53-AU,822,2026.70,96,403.70,918,2430.40,20140801
CGG_RSX1-AU,411,629.95,22,88.05,433,718.00,20140801
CGG_RSX2-AU,680,1422.90,40,151.20,720,1574.10,20140801
CGG_RSX3-AU,491,1160.25,45,191.85,536,1352.10,20140801
CGG_RT12-AU,1120,3041.85,117,638.70,1237,3680.55,20140801
CGG_SS31-AU,635,1435.65,31,132.45,666,1568.10,20140801
CGG_SS32-AU,572,1146.05,26,106.25,598,1252.30,20140801
CGG_SW30-AU,304,1150.20,81,907.50,385,2057.70,20140801
CGG_SW31-AU,853,2519.80,116,474.35,969,2994.15,20140801
CGG_SW32-AU,278,1011.05,110,1161.85,388,2172.90,20140801
CGG_SW33-AU,594,1779.30,90,393.75,684,2173.05,20140801
CGG_SW34-AU,520,2085.95,178,2343.75,698,4429.70,20140801
CGG_SW35-AU,829,2543.35,119,473.65,948,3017.00,20140801
CGG_TM10-AU,1680,5063.35,389,1815.45,2069,6878.80,20140801
CGG_TMX3-AU,934,3272.55,384,2953.70,1318,6226.25,20140801
CGG_TMX4-AU,1448,5034.45,353,2402.40,1801,7436.85,20140801
CGG_TMX5-AU,1538,5037.65,563,4032.30,2101,9069.95,20140801
CGG_TMX6-AU,1556,5435.95,481,3490.45,2037,8926.40,20140801
CGG_TMX7-AU,1161,3510.30,386,1782.35,1547,5292.65,20140801
CGG_TMX8-AU,1935,5754.20,1137,5411.75,3072,11165.95,20140801
CGG_TMX9-AU,2044,5678.80,508,2272.95,2552,7951.75,20140801
CGG_TPX1-AU,1012,2074.40,152,571.20,1164,2645.60,20140801
CGG_US10-AU,1069,2081.15,76,221.20,1145,2302.35,20140801
CGG_WES1-AU,298,1390.05,79,584.35,377,1974.40,20140801
CGG_WES2-AU,520,2180.80,152,1042.50,672,3223.30,20140801
CGG_YA11-AU,740,1398.05,37,101.15,777,1499.20,20140801
CGG_YA13-AU,1755,3238.30,96,294.25,1851,3532.55,20140801
CGG_YA14-AU,1487,2645.75,78,232.40,1565,2878.15,20140801
CGG_YA18-AU,1044,2029.45,78,223.00,1122,2252.45,20140801
CGG_YA20-AU,1406,2920.85,120,394.85,1526,3315.70,20140801
CGG_YA21-AU,1023,1862.70,62,156.75,1085,2019.45,20140801
CGG_YA23-AU,895,1757.05,60,177.50,955,1934.55,20140801
CGG_YA31-AU,1522,3642.55,121,394.20,1643,4036.75,20140801
CGG_YA32-AU,1033,2329.00,64,214.35,1097,2543.35,20140801
CGG_YA34-AU,918,2404.00,76,377.50,994,2781.50,20140801
CGG_YA35-AU,937,2857.85,111,539.95,1048,3397.80,20140801
CGG_YA36-AU,676,1808.10,87,466.85,763,2274.95,20140801
CGG_YAX1-AU,566,1744.95,84,404.90,650,2149.85,20140801
CGG_YAX2-AU,535,1471.00,58,263.05,593,1734.05,20140801
CGG_YAX3-AU,158,461.15,28,151.85,186,613.00,20140801
CGG_YAX4-AU,265,731.80,32,152.50,297,884.30,20140801
CGG_YCX1-AU,282,763.70,59,290.00,341,1053.70,20140801
CGG_AP21-AU,508,1223.80,69,291.45,577,1515.25,20140701
CGG_BC21-AU,267,1134.45,195,2475.55,462,3610.00,20140701
CGG_BC41-AU,375,1556.80,203,1160.00,578,2716.80,20140701
CGG_BC42-AU,143,679.45,49,275.00,192,954.45,20140701
CGG_BC43-AU,245,1030.05,257,1494.50,502,2524.55,20140701
CGG_BR22-AU,561,1301.95,114,446.25,675,1748.20,20140701
CGG_BR23-AU,688,1991.40,190,1057.35,878,3048.75,20140701
CGG_BR26-AU,861,2051.30,132,520.30,993,2571.60,20140701
CGG_BR31-AU,869,2219.70,110,500.00,979,2719.70,20140701
CGG_BR32-AU,735,1544.82,19,54.30,754,1599.12,20140701
CGG_BR33-AU,452,1094.00,26,119.25,478,1213.25,20140701
CGG_BR34-AU,1462,2788.65,89,297.25,1551,3085.90,20140701
CGG_BR35-AU,601,1464.10,42,190.05,643,1654.15,20140701
CGG_BR41-AU,100,471.50,72,414.75,172,886.25,20140701
CGG_BR42-AU,581,1526.10,129,540.25,710,2066.35,20140701
CGG_BR43-AU,68,340.00,81,470.00,149,810.00,20140701
CGG_BR44-AU,339,898.30,21,98.75,360,997.05,20140701
CGG_BR45-AU,98,503.45,167,972.00,265,1475.45,20140701
CGG_BS11-AU,160,863.30,244,1440.60,404,2303.90,20140701
CGG_BS12-AU,314,901.90,60,325.50,374,1227.40,20140701
CGG_BS13-AU,152,830.35,96,554.50,248,1384.85,20140701
CGG_BS16-AU,107,456.70,118,681.00,225,1137.70,20140701
CGG_BS17-AU,607,1801.45,64,505.80,671,2307.25,20140701
CGG_BS18-AU,631,1589.90,109,572.00,740,2161.90,20140701
CGG_BS21-AU,1599,3488.40,110,402.70,1709,3891.10,20140701
CGG_BS22-AU,1054,1962.80,50,144.80,1104,2107.60,20140701
CGG_BS23-AU,1090,2362.65,78,269.70,1168,2632.35,20140701
CGG_BS24-AU,1172,2361.80,76,225.95,1248,2587.75,20140701
CGG_BS25-AU,1416,3247.65,116,398.65,1532,3646.30,20140701
CGG_BS26-AU,2040,4611.60,160,565.15,2200,5176.75,20140701
CGG_BS27-AU,2332,5979.05,216,781.30,2548,6760.35,20140701
CGG_BS29-AU,860,2461.50,75,297.45,935,2758.95,20140701
CGG_BS31-AU,819,2291.80,75,308.00,894,2599.80,20140701
CGG_BS32-AU,1188,3226.35,105,389.55,1293,3615.90,20140701
CGG_BS34-AU,211,563.85,11,36.25,222,600.10,20140701
CGG_BS35-AU,745,2033.25,62,249.25,807,2282.50,20140701
CGG_BS36-AU,1950,5547.55,134,541.95,2084,6089.50,20140701
CGG_BS37-AU,1872,5350.95,136,554.45,2008,5905.40,20140701
CGG_CCX1-AU,162,1138.95,280,4030.30,442,5169.25,20140701
CGG_CCX2-AU,291,1850.25,187,2715.70,478,4565.95,20140701
CGG_CCX3-AU,40,245.80,60,817.60,100,1063.40,20140701
CGG_CCX4-AU,52,261.90,34,457.50,86,719.40,20140701
CGG_CCX5-AU,211,1827.40,335,5340.40,546,7167.80,20140701
CGG_CCX6-AU,47,317.55,129,2023.70,176,2341.25,20140701
CGG_CL11-AU,888,2015.10,139,508.50,1027,2523.60,20140701
CGG_CLX2-AU,898,2053.45,118,433.10,1016,2486.55,20140701
CGG_CPX1-AU,1548,5180.85,237,1292.20,1785,6473.05,20140701
CGG_CPX2-AU,1084,3694.65,268,1627.45,1352,5322.10,20140701
CGG_CS21-AU,1050,3198.80,186,1031.20,1236,4230.00,20140701
CGG_CS22-AU,818,1812.35,121,440.40,939,2252.75,20140701
CGG_EB29-AU,342,1059.10,70,393.25,412,1452.35,20140701
CGG_EB31-AU,575,1603.90,82,406.25,657,2010.15,20140701
CGG_EB32-AU,751,1955.85,79,366.75,830,2322.60,20140701
CGG_EB33-AU,1414,3770.25,132,563.40,1546,4333.65,20140701
CGG_EB34-AU,1048,2407.10,92,342.95,1140,2750.05,20140701
CGG_EB35-AU,983,2846.50,108,471.10,1091,3317.60,20140701
CGG_EB36-AU,1172,3165.30,132,570.90,1304,3736.20,20140701
CGG_EB41-AU,576,1824.50,80,559.85,656,2384.35,20140701
CGG_EB42-AU,109,559.35,116,671.60,225,1230.95,20140701
CGG_EB44-AU,72,312.75,164,950.25,236,1263.00,20140701
CGG_EB46-AU,114,494.45,105,614.50,219,1108.95,20140701
CGG_FM21-AU,620,2562.70,243,2940.20,863,5502.90,20140701
CGG_FM22-AU,491,2053.50,284,3539.25,775,5592.75,20140701
CGG_FM23-AU,312,1666.45,272,3861.55,584,5528.00,20140701
CGG_FM24-AU,295,1534.05,257,3436.65,552,4970.70,20140701
CGG_FS21-AU,352,1289.85,121,1325.15,473,2615.00,20140701
CGG_FS22-AU,480,1679.85,119,670.50,599,2350.35,20140701
CGG_FS23-AU,147,659.75,133,1926.25,280,2586.00,20140701
CGG_FS24-AU,0,0.00,0,0.00,0,0.00,20140701
CGG_FS25-AU,372,1185.95,90,534.35,462,1720.30,20140701
CGG_FS26-AU,347,1194.70,108,670.95,455,1865.65,20140701
CGG_FS31-AU,1001,2091.10,69,258.10,1070,2349.20,20140701
CGG_FS32-AU,1153,2587.05,133,503.90,1286,3090.95,20140701
CGG_FS33-AU,2253,4439.80,121,399.85,2374,4839.65,20140701
CGG_GC13-AU,237,1022.75,155,891.00,392,1913.75,20140701
CGG_GH15-AU,234,676.35,75,336.25,309,1012.60,20140701
CGG_GH21-AU,534,991.45,36,124.85,570,1116.30,20140701
CGG_GH23-AU,1123,2000.15,85,271.05,1208,2271.20,20140701
CGG_GH24-AU,1705,3302.45,160,559.95,1865,3862.40,20140701
CGG_GH31-AU,1452,2600.00,125,419.95,1577,3019.95,20140701
CGG_GH32-AU,1264,2433.75,103,356.75,1367,2790.50,20140701
CGG_GH33-AU,759,1796.70,48,242.50,807,2039.20,20140701
CGG_GH34-AU,1055,2443.55,100,356.80,1155,2800.35,20140701
CGG_GH36-AU,1274,2898.50,75,258.35,1349,3156.85,20140701
CGG_GHX1-AU,1060,3580.90,297,1644.65,1357,5225.55,20140701
CGG_GHX3-AU,663,2014.75,196,1067.60,859,3082.35,20140701
CGG_GHX5-AU,651,2431.70,195,1166.45,846,3598.15,20140701
CGG_GM11-AU,183,664.85,80,364.60,263,1029.45,20140701
CGG_GM16-AU,170,525.70,24,97.75,194,623.45,20140701
CGG_HAY1-AU,458,3456.45,891,7752.20,1349,11208.65,20140701
CGG_HAY2-AU,543,3944.20,827,7193.70,1370,11137.90,20140701
CGG_HAY3-AU,856,4944.25,573,4898.40,1429,9842.65,20140701
CGG_JSX1-AU,1266,2746.60,119,429.05,1385,3175.65,20140701
CGG_JSX2-AU,1407,2889.50,96,322.15,1503,3211.65,20140701
CGG_LM11-AU,823,1652.10,63,239.00,886,1891.10,20140701
CGG_LM12-AU,819,1408.10,73,250.10,892,1658.20,20140701
CGG_LM13-AU,0,0.00,0,0.00,0,0.00,20140701
CGG_LM14-AU,500,853.10,31,127.35,531,980.45,20140701
CGG_LM15-AU,552,1183.90,27,104.70,579,1288.60,20140701
CGG_LM16-AU,897,1936.70,126,493.90,1023,2430.60,20140701
CGG_LM30-AU,1102,1796.25,64,201.20,1166,1997.45,20140701
CGG_LM32-AU,2017,3362.75,109,314.50,2126,3677.25,20140701
CGG_LM41-AU,1156,1925.40,47,123.55,1203,2048.95,20140701
CGG_LM42-AU,1110,1789.05,74,203.60,1184,1992.65,20140701
CGG_LM43-AU,1711,2204.75,45,103.75,1756,2308.50,20140701
CGG_LM44-AU,1763,2668.65,116,374.60,1879,3043.25,20140701
CGG_LMX2-AU,260,1095.25,176,2082.85,436,3178.10,20140701
CGG_LR11-AU,1025,2058.70,58,190.70,1083,2249.40,20140701
CGG_LR12-AU,1550,2947.55,91,285.50,1641,3233.05,20140701
CGG_LR13-AU,2642,5218.75,173,537.25,2815,5756.00,20140701
CGG_LR14-AU,1166,2271.40,50,159.00,1216,2430.40,20140701
CGG_LR15-AU,231,1066.20,58,305.00,289,1371.20,20140701
CGG_LR16-AU,1152,2540.70,151,525.30,1303,3066.00,20140701
CGG_LR31-AU,394,1182.20,71,386.25,465,1568.45,20140701
CGG_LR33-AU,541,1664.15,120,701.60,661,2365.75,20140701
CGG_LR43-AU,942,2492.20,82,359.15,1024,2851.35,20140701
CGG_LR47-AU,1299,3884.25,135,643.95,1434,4528.20,20140701
CGG_MB11-AU,891,1841.20,35,97.95,926,1939.15,20140701
CGG_MB12-AU,1341,2766.20,98,298.15,1439,3064.35,20140701
CGG_MB13-AU,791,1669.25,33,107.55,824,1776.80,20140701
CGG_MB14-AU,872,1693.45,44,149.80,916,1843.25,20140701
CGG_MB15-AU,598,1013.70,39,122.25,637,1135.95,20140701
CGG_MB16-AU,858,1515.90,60,187.15,918,1703.05,20140701
CGG_MB17-AU,1233,2206.25,85,294.80,1318,2501.05,20140701
CGG_MB23-AU,1581,2581.90,74,188.35,1655,2770.25,20140701
CGG_MB31-AU,2319,3586.25,90,260.25,2409,3846.50,20140701
CGG_MB32-AU,1908,2599.75,81,208.75,1989,2808.50,20140701
CGG_MB33-AU,1772,2945.50,82,260.15,1854,3205.65,20140701
CGG_MB34-AU,1576,2251.20,49,134.45,1625,2385.65,20140701
CGG_MB35-AU,1238,2712.90,113,434.70,1351,3147.60,20140701
CGG_MB36-AU,2220,3495.50,120,356.90,2340,3852.40,20140701
CGG_MB37-AU,1144,2063.90,113,399.00,1257,2462.90,20140701
CGG_MB38-AU,1971,3142.05,68,215.20,2039,3357.25,20140701
CGG_MB41-AU,1612,2789.25,82,220.70,1694,3009.95,20140701
CGG_MB42-AU,1053,2299.00,64,226.35,1117,2525.35,20140701
CGG_MB44-AU,1094,2004.95,66,216.70,1160,2221.65,20140701
CGG_MBX1-AU,1211,3082.95,132,498.90,1343,3581.85,20140701
CGG_MBX2-AU,1113,2757.30,138,514.40,1251,3271.70,20140701
CGG_MBX4-AU,912,2105.90,88,333.20,1000,2439.10,20140701
CGG_MC21-AU,1540,3942.20,142,871.05,1682,4813.25,20140701
CGG_MC22-AU,1539,3820.50,145,933.00,1684,4753.50,20140701
CGG_MC23-AU,1207,2903.10,84,487.20,1291,3390.30,20140701
CGG_MK31-AU,264,1016.60,51,296.60,315,1313.20,20140701
CGG_MK34-AU,249,777.90,39,202.35,288,980.25,20140701
CGG_MK35-AU,157,401.65,28,153.50,185,555.15,20140701
CGG_MM41-AU,2067,3494.35,76,211.95,2143,3706.30,20140701
CGG_MS10-AU,667,1112.95,46,131.05,713,1244.00,20140701
CGG_MS11-AU,1121,2046.80,80,263.95,1201,2310.75,20140701
CGG_MS12-AU,1843,2968.35,110,346.25,1953,3314.60,20140701
CGG_MS21-AU,1730,3039.25,105,376.30,1835,3415.55,20140701
CGG_MS30-AU,716,1213.80,43,129.05,759,1342.85,20140701
CGG_MS31-AU,2216,4061.15,196,659.40,2412,4720.55,20140701
CGG_MS32-AU,1580,2694.70,109,303.30,1689,2998.00,20140701
CGG_MS41-AU,1030,1849.45,63,157.70,1093,2007.15,20140701
CGG_MS42-AU,2005,2615.35,113,220.10,2118,2835.45,20140701
CGG_MS43-AU,1907,3129.20,117,345.20,2024,3474.40,20140701
CGG_MS44-AU,1661,2345.10,70,173.40,1731,2518.50,20140701
CGG_MS46-AU,1445,2023.25,55,152.85,1500,2176.10,20140701
CGG_MY21-AU,1096,2217.10,7,20.35,1103,2237.45,20140701
CGG_MY22-AU,1072,2541.25,76,245.10,1148,2786.35,20140701
CGG_MY23-AU,814,1743.05,59,195.30,873,1938.35,20140701
CGG_MY25-AU,1305,2733.55,83,263.15,1388,2996.70,20140701
CGG_MY31-AU,690,1517.85,63,233.25,753,1751.10,20140701
CGG_MY32-AU,859,2030.20,82,289.45,941,2319.65,20140701
CGG_MY33-AU,373,1034.85,58,246.75,431,1281.60,20140701
CGG_MY34-AU,425,1273.85,33,140.50,458,1414.35,20140701
CGG_MY35-AU,374,1056.35,43,173.50,417,1229.85,20140701
CGG_MY41-AU,1784,3815.55,119,390.25,1903,4205.80,20140701
CGG_MY42-AU,2658,4930.90,137,402.60,2795,5333.50,20140701
CGG_MY43-AU,948,2705.60,70,263.70,1018,2969.30,20140701
CGG_MY44-AU,528,1643.20,27,97.20,555,1740.40,20140701
CGG_MY45-AU,1083,3176.70,108,431.00,1191,3607.70,20140701
CGG_MY46-AU,1783,5331.85,149,610.45,1932,5942.30,20140701
CGG_MY47-AU,1356,3967.80,98,366.35,1454,4334.15,20140701
CGG_MY51-AU,1083,3734.50,136,756.00,1219,4490.50,20140701
CGG_MY52-AU,1062,3975.90,206,1465.60,1268,5441.50,20140701
CGG_MY53-AU,778,2601.45,87,477.00,865,3078.45,20140701
CGG_MY54-AU,996,3872.50,222,1595.45,1218,5467.95,20140701
CGG_MY55-AU,1128,3930.70,176,970.60,1304,4901.30,20140701
CGG_MY56-AU,1207,5023.40,247,1763.95,1454,6787.35,20140701
CGG_MY57-AU,1186,4270.95,146,769.95,1332,5040.90,20140701
CGG_PNR1-AU,853,2574.30,233,699.00,1086,3273.30,20140701
CGG_PNR2-AU,111,336.00,12,36.00,123,372.00,20140701
CGG_RBX4-AU,154,433.20,16,59.25,170,492.45,20140701
CGG_RBX5-AU,200,885.15,88,425.00,288,1310.15,20140701
CGG_RBX6-AU,375,1775.10,317,1543.00,692,3318.10,20140701
CGG_RBX7-AU,234,1040.55,276,1337.75,510,2378.30,20140701
CGG_RS11-AU,737,1154.50,38,137.00,775,1291.50,20140701
CGG_RS13-AU,529,806.45,43,156.10,572,962.55,20140701
CGG_RS14-AU,1600,1815.25,54,149.25,1654,1964.50,20140701
CGG_RS15-AU,662,1279.85,110,410.10,772,1689.95,20140701
CGG_RS16-AU,1546,2255.75,67,201.90,1613,2457.65,20140701
CGG_RS20-AU,1380,2052.90,77,225.20,1457,2278.10,20140701
CGG_RS21-AU,1564,2482.20,80,218.05,1644,2700.25,20140701
CGG_RS22-AU,2454,3671.60,114,323.85,2568,3995.45,20140701
CGG_RS23-AU,1705,2746.55,85,258.00,1790,3004.55,20140701
CGG_RS30-AU,1460,2548.00,98,296.20,1558,2844.20,20140701
CGG_RS31-AU,1752,3196.50,71,262.95,1823,3459.45,20140701
CGG_RS32-AU,1308,2563.60,88,297.60,1396,2861.20,20140701
CGG_RS33-AU,1110,2202.95,78,257.10,1188,2460.05,20140701
CGG_RS41-AU,1347,2695.85,132,425.50,1479,3121.35,20140701
CGG_RS42-AU,1494,3275.50,105,361.30,1599,3636.80,20140701
CGG_RS43-AU,765,1490.90,81,238.50,846,1729.40,20140701
CGG_RS44-AU,563,1254.35,66,233.70,629,1488.05,20140701
CGG_RS45-AU,1540,3032.60,136,440.30,1676,3472.90,20140701
CGG_RS46-AU,923,2168.15,80,322.50,1003,2490.65,20140701
CGG_RS50-AU,466,913.25,27,60.45,493,973.70,20140701
CGG_RS53-AU,928,2282.05,90,328.20,1018,2610.25,20140701
CGG_RSX1-AU,452,611.20,15,49.55,467,660.75,20140701
CGG_RSX2-AU,688,1287.75,42,160.55,730,1448.30,20140701
CGG_RSX3-AU,507,1094.45,58,251.10,565,1345.55,20140701
CGG_RT12-AU,613,1550.30,81,437.45,694,1987.75,20140701
CGG_SS31-AU,771,1614.40,42,218.35,813,1832.75,20140701
CGG_SS32-AU,515,986.20,33,130.35,548,1116.55,20140701
CGG_SW30-AU,368,1349.00,79,655.35,447,2004.35,20140701
CGG_SW31-AU,948,2561.95,106,442.20,1054,3004.15,20140701
CGG_SW32-AU,321,1206.65,93,948.00,414,2154.65,20140701
CGG_SW33-AU,625,1790.00,66,279.75,691,2069.75,20140701
CGG_SW34-AU,568,2303.25,205,2499.35,773,4802.60,20140701
CGG_SW35-AU,935,2635.20,103,437.50,1038,3072.70,20140701
CGG_TM10-AU,1764,5069.30,459,2078.65,2223,7147.95,20140701
CGG_TMX3-AU,1200,4281.90,324,2358.65,1524,6640.55,20140701
CGG_TMX4-AU,1713,5665.40,394,2703.50,2107,8368.90,20140701
CGG_TMX5-AU,1670,5425.90,537,3886.95,2207,9312.85,20140701
CGG_TMX6-AU,1740,5993.50,620,4525.80,2360,10519.30,20140701
CGG_TMX7-AU,1513,4294.35,386,1728.80,1899,6023.15,20140701
CGG_TMX8-AU,2097,6009.75,1140,5265.90,3237,11275.65,20140701
CGG_TMX9-AU,2341,6442.80,462,2033.45,2803,8476.25,20140701
CGG_TPX1-AU,1106,2240.75,151,506.30,1257,2747.05,20140701
CGG_US10-AU,1130,2291.50,71,216.55,1201,2508.05,20140701
CGG_WES1-AU,470,2146.50,163,1195.70,633,3342.20,20140701
CGG_WES2-AU,717,3256.15,179,1238.75,896,4494.90,20140701
CGG_YA11-AU,850,1632.20,41,112.40,891,1744.60,20140701
CGG_YA13-AU,2109,3860.75,129,383.70,2238,4244.45,20140701
CGG_YA14-AU,1257,2242.85,83,222.30,1340,2465.15,20140701
CGG_YA18-AU,1209,2377.70,84,265.35,1293,2643.05,20140701
CGG_YA20-AU,1594,3241.75,137,457.10,1731,3698.85,20140701
CGG_YA21-AU,1017,1798.95,58,160.20,1075,1959.15,20140701
CGG_YA23-AU,971,1926.85,63,196.45,1034,2123.30,20140701
CGG_YA31-AU,1630,3842.75,148,519.45,1778,4362.20,20140701
CGG_YA32-AU,1148,2610.30,78,295.35,1226,2905.65,20140701
CGG_YA34-AU,996,2531.35,114,581.35,1110,3112.70,20140701
CGG_YA35-AU,1066,3141.65,119,607.60,1185,3749.25,20140701
CGG_YA36-AU,739,2073.85,78,431.20,817,2505.05,20140701
CGG_YAX1-AU,605,1764.65,109,524.35,714,2289.00,20140701
CGG_YAX2-AU,560,1508.10,50,199.35,610,1707.45,20140701
CGG_YAX3-AU,231,739.10,27,135.00,258,874.10,20140701
CGG_YAX4-AU,336,908.30,23,118.25,359,1026.55,20140701
CGG_YCX1-AU,301,699.05,39,235.25,340,934.30,20140701
CGG_AP21-AU,457,958.70,70,241.60,527,1200.30,20140601
CGG_BC21-AU,204,765.35,140,1608.60,344,2373.95,20140601
CGG_BC41-AU,289,978.05,140,683.00,429,1661.05,20140601
CGG_BC42-AU,87,304.35,41,194.60,128,498.95,20140601
CGG_BC43-AU,167,600.35,261,1290.00,428,1890.35,20140601
CGG_BR22-AU,473,913.45,78,257.60,551,1171.05,20140601
CGG_BR23-AU,609,1592.05,163,755.40,772,2347.45,20140601
CGG_BR26-AU,671,1344.05,112,348.80,783,1692.85,20140601
CGG_BR31-AU,602,1372.00,73,300.20,675,1672.20,20140601
CGG_BR32-AU,645,1171.60,16,38.60,661,1210.20,20140601
CGG_BR33-AU,283,625.55,26,122.00,309,747.55,20140601
CGG_BR34-AU,1235,2149.55,71,154.20,1306,2303.75,20140601
CGG_BR35-AU,754,1647.80,59,242.40,813,1890.20,20140601
CGG_BR41-AU,114,450.25,98,478.00,212,928.25,20140601
CGG_BR42-AU,458,1078.80,106,382.80,564,1461.60,20140601
CGG_BR43-AU,81,355.50,106,524.60,187,880.10,20140601
CGG_BR44-AU,243,527.95,7,24.00,250,551.95,20140601
CGG_BR45-AU,76,347.65,90,446.00,166,793.65,20140601
CGG_BS11-AU,142,693.85,145,725.00,287,1418.85,20140601
CGG_BS12-AU,255,660.25,46,218.00,301,878.25,20140601
CGG_BS13-AU,117,555.10,111,554.00,228,1109.10,20140601
CGG_BS16-AU,113,484.70,99,495.00,212,979.70,20140601
CGG_BS17-AU,404,1069.40,60,439.00,464,1508.40,20140601
CGG_BS18-AU,386,928.05,78,339.00,464,1267.05,20140601
CGG_BS21-AU,1248,2412.35,58,165.20,1306,2577.55,20140601
CGG_BS22-AU,826,1409.00,46,117.20,872,1526.20,20140601
CGG_BS23-AU,918,1800.90,69,218.60,987,2019.50,20140601
CGG_BS24-AU,991,1806.70,52,143.60,1043,1950.30,20140601
CGG_BS25-AU,1362,2800.20,84,260.20,1446,3060.40,20140601
CGG_BS26-AU,1730,3575.35,88,229.20,1818,3804.55,20140601
CGG_BS27-AU,1859,4305.45,111,309.40,1970,4614.85,20140601
CGG_BS29-AU,755,1827.70,54,176.00,809,2003.70,20140601
CGG_BS31-AU,674,1651.15,50,156.60,724,1807.75,20140601
CGG_BS32-AU,951,2328.90,61,200.00,1012,2528.90,20140601
CGG_BS34-AU,146,375.25,2,4.00,148,379.25,20140601
CGG_BS35-AU,629,1515.25,35,109.20,664,1624.45,20140601
CGG_BS36-AU,1632,4088.10,129,414.20,1761,4502.30,20140601
CGG_BS37-AU,1530,3736.45,109,372.00,1639,4108.45,20140601
CGG_CCX1-AU,132,886.55,217,2866.60,349,3753.15,20140601
CGG_CCX2-AU,283,1971.00,199,2284.40,482,4255.40,20140601
CGG_CCX3-AU,66,346.60,50,547.80,116,894.40,20140601
CGG_CCX4-AU,65,338.85,46,411.60,111,750.45,20140601
CGG_CCX5-AU,179,1411.95,221,2815.80,400,4227.75,20140601
CGG_CCX6-AU,52,326.65,97,1250.40,149,1577.05,20140601
CGG_CL11-AU,729,1471.40,79,232.80,808,1704.20,20140601
CGG_CLX2-AU,598,1154.45,45,126.20,643,1280.65,20140601
CGG_CPX1-AU,1043,2775.00,171,688.40,1214,3463.40,20140601
CGG_CPX2-AU,583,1516.90,85,352.40,668,1869.30,20140601
CGG_CS21-AU,861,2363.95,154,745.00,1015,3108.95,20140601
CGG_CS22-AU,723,1441.50,104,313.80,827,1755.30,20140601
CGG_EB29-AU,286,719.35,31,126.60,317,845.95,20140601
CGG_EB31-AU,492,1213.45,36,118.20,528,1331.65,20140601
CGG_EB32-AU,581,1308.60,63,230.20,644,1538.80,20140601
CGG_EB33-AU,1103,2520.05,96,339.00,1199,2859.05,20140601
CGG_EB34-AU,810,1607.15,71,227.60,881,1834.75,20140601
CGG_EB35-AU,698,1796.20,88,353.80,786,2150.00,20140601
CGG_EB36-AU,875,2169.15,84,332.00,959,2501.15,20140601
CGG_EB41-AU,429,1239.75,46,292.00,475,1531.75,20140601
CGG_EB42-AU,111,438.15,93,458.60,204,896.75,20140601
CGG_EB44-AU,64,265.40,134,667.00,198,932.40,20140601
CGG_EB46-AU,60,227.60,93,465.00,153,692.60,20140601
CGG_FM21-AU,477,1982.50,240,2342.00,717,4324.50,20140601
CGG_FM22-AU,442,1929.50,248,2393.90,690,4323.40,20140601
CGG_FM23-AU,326,1449.80,246,2765.45,572,4215.25,20140601
CGG_FM24-AU,263,1144.40,153,1701.10,416,2845.50,20140601
CGG_FS21-AU,192,760.15,97,1102.60,289,1862.75,20140601
CGG_FS22-AU,478,1396.40,132,625.20,610,2021.60,20140601
CGG_FS23-AU,155,639.30,99,1158.05,254,1797.35,20140601
CGG_FS24-AU,0,0.00,0,0.00,0,0.00,20140601
CGG_FS25-AU,277,753.75,117,599.60,394,1353.35,20140601
CGG_FS26-AU,329,1018.13,96,462.00,425,1480.13,20140601
CGG_FS31-AU,652,1244.70,63,195.80,715,1440.50,20140601
CGG_FS32-AU,893,1874.75,135,459.60,1028,2334.35,20140601
CGG_FS33-AU,1287,2217.40,71,185.60,1358,2403.00,20140601
CGG_GC13-AU,224,850.65,109,516.00,333,1366.65,20140601
CGG_GH15-AU,187,484.35,55,197.00,242,681.35,20140601
CGG_GH21-AU,455,711.70,29,83.00,484,794.70,20140601
CGG_GH23-AU,933,1496.85,76,199.20,1009,1696.05,20140601
CGG_GH24-AU,1284,2230.95,111,337.80,1395,2568.75,20140601
CGG_GH31-AU,1067,1740.95,77,218.80,1144,1959.75,20140601
CGG_GH32-AU,1029,1776.50,70,180.00,1099,1956.50,20140601
CGG_GH33-AU,684,1458.50,34,138.00,718,1596.50,20140601
CGG_GH34-AU,884,1799.75,62,180.20,946,1979.95,20140601
CGG_GH36-AU,1122,2255.60,53,134.60,1175,2390.20,20140601
CGG_GHX1-AU,725,1808.15,122,491.80,847,2299.95,20140601
CGG_GHX3-AU,502,1165.15,86,362.80,588,1527.95,20140601
CGG_GHX5-AU,349,941.35,85,403.60,434,1344.95,20140601
CGG_GM11-AU,140,384.85,46,170.00,186,554.85,20140601
CGG_GM16-AU,162,457.70,22,80.00,184,537.70,20140601
CGG_HAY1-AU,488,3081.50,709,5196.40,1197,8277.90,20140601
CGG_HAY2-AU,544,3331.05,727,5352.15,1271,8683.20,20140601
CGG_HAY3-AU,925,4942.75,793,5828.90,1718,10771.65,20140601
CGG_JSX1-AU,994,1967.10,83,219.80,1077,2186.90,20140601
CGG_JSX2-AU,1035,1987.55,91,253.20,1126,2240.75,20140601
CGG_LM11-AU,757,1381.00,53,153.20,810,1534.20,20140601
CGG_LM12-AU,832,1259.55,60,183.60,892,1443.15,20140601
CGG_LM13-AU,0,0.00,0,0.00,0,0.00,20140601
CGG_LM14-AU,448,656.60,40,124.60,488,781.20,20140601
CGG_LM15-AU,585,1124.20,14,40.00,599,1164.20,20140601
CGG_LM16-AU,756,1426.80,103,318.40,859,1745.20,20140601
CGG_LM30-AU,895,1309.00,45,96.40,940,1405.40,20140601
CGG_LM32-AU,1677,2487.70,68,160.00,1745,2647.70,20140601
CGG_LM41-AU,930,1384.75,46,97.60,976,1482.35,20140601
CGG_LM42-AU,912,1340.00,56,123.40,968,1463.40,20140601
CGG_LM43-AU,1514,1790.25,71,170.20,1585,1960.45,20140601
CGG_LM44-AU,1436,1980.55,85,202.00,1521,2182.55,20140601
CGG_LMX2-AU,265,1128.90,125,1218.85,390,2347.75,20140601
CGG_LR11-AU,578,1097.10,54,163.80,632,1260.90,20140601
CGG_LR12-AU,1026,1823.10,47,121.20,1073,1944.30,20140601
CGG_LR13-AU,1715,3131.65,125,333.40,1840,3465.05,20140601
CGG_LR14-AU,789,1456.90,41,117.60,830,1574.50,20140601
CGG_LR15-AU,184,770.10,36,166.00,220,936.10,20140601
CGG_LR16-AU,734,1440.35,163,480.00,897,1920.35,20140601
CGG_LR31-AU,321,850.65,37,148.20,358,998.85,20140601
CGG_LR33-AU,521,1325.80,80,364.60,601,1690.40,20140601
CGG_LR43-AU,730,1731.10,60,222.60,790,1953.70,20140601
CGG_LR47-AU,1052,2704.40,87,348.80,1139,3053.20,20140601
CGG_MB11-AU,740,1300.20,33,74.60,773,1374.80,20140601
CGG_MB12-AU,1145,2077.60,76,206.40,1221,2284.00,20140601
CGG_MB13-AU,681,1246.35,22,64.00,703,1310.35,20140601
CGG_MB14-AU,761,1201.85,47,125.60,808,1327.45,20140601
CGG_MB15-AU,513,842.20,43,103.00,556,945.20,20140601
CGG_MB16-AU,729,1182.40,39,91.60,768,1274.00,20140601
CGG_MB17-AU,1045,1658.95,58,175.00,1103,1833.95,20140601
CGG_MB23-AU,1326,1861.40,48,112.40,1374,1973.80,20140601
CGG_MB31-AU,1742,2408.90,100,224.40,1842,2633.30,20140601
CGG_MB32-AU,1486,1918.55,50,104.60,1536,2023.15,20140601
CGG_MB33-AU,1539,2241.25,63,151.20,1602,2392.45,20140601
CGG_MB34-AU,1260,1650.75,49,101.80,1309,1752.55,20140601
CGG_MB35-AU,1045,1993.05,70,232.00,1115,2225.05,20140601
CGG_MB36-AU,1873,2578.45,96,247.60,1969,2826.05,20140601
CGG_MB37-AU,909,1471.40,83,253.60,992,1725.00,20140601
CGG_MB38-AU,1609,2347.00,53,126.20,1662,2473.20,20140601
CGG_MB41-AU,1237,1945.75,74,185.60,1311,2131.35,20140601
CGG_MB42-AU,976,2112.60,45,133.60,1021,2246.20,20140601
CGG_MB44-AU,977,1831.30,44,129.60,1021,1960.90,20140601
CGG_MBX1-AU,1036,2274.20,115,347.00,1151,2621.20,20140601
CGG_MBX2-AU,882,1976.15,113,347.60,995,2323.75,20140601
CGG_MBX4-AU,613,1333.60,74,231.60,687,1565.20,20140601
CGG_MC21-AU,1233,2888.05,120,621.00,1353,3509.05,20140601
CGG_MC22-AU,1396,3128.75,104,549.25,1500,3678.00,20140601
CGG_MC23-AU,540,1163.45,36,145.00,576,1308.45,20140601
CGG_MK31-AU,189,624.70,40,193.60,229,818.30,20140601
CGG_MK34-AU,225,627.40,27,124.00,252,751.40,20140601
CGG_MK35-AU,149,396.40,24,114.00,173,510.40,20140601
CGG_MM41-AU,1852,2647.95,80,174.60,1932,2822.55,20140601
CGG_MS10-AU,538,800.30,30,80.20,568,880.50,20140601
CGG_MS11-AU,842,1366.55,54,133.20,896,1499.75,20140601
CGG_MS12-AU,1503,2171.80,80,186.40,1583,2358.20,20140601
CGG_MS21-AU,1294,2052.30,71,186.80,1365,2239.10,20140601
CGG_MS30-AU,660,982.30,43,113.40,703,1095.70,20140601
CGG_MS31-AU,1695,2789.05,125,315.00,1820,3104.05,20140601
CGG_MS32-AU,1215,1873.00,82,197.60,1297,2070.60,20140601
CGG_MS41-AU,919,1385.65,55,113.60,974,1499.25,20140601
CGG_MS42-AU,1600,1928.35,70,135.00,1670,2063.35,20140601
CGG_MS43-AU,1376,2019.65,74,198.40,1450,2218.05,20140601
CGG_MS44-AU,1404,1785.30,58,101.00,1462,1886.30,20140601
CGG_MS46-AU,1223,1561.35,40,84.40,1263,1645.75,20140601
CGG_MY21-AU,892,1700.85,15,32.20,907,1733.05,20140601
CGG_MY22-AU,1216,2532.05,58,155.00,1274,2687.05,20140601
CGG_MY23-AU,656,1234.40,35,102.80,691,1337.20,20140601
CGG_MY25-AU,1141,2195.40,60,146.80,1201,2342.20,20140601
CGG_MY31-AU,515,1115.90,58,180.60,573,1296.50,20140601
CGG_MY32-AU,649,1381.00,66,186.20,715,1567.20,20140601
CGG_MY33-AU,352,832.40,43,138.60,395,971.00,20140601
CGG_MY34-AU,396,1019.05,35,118.00,431,1137.05,20140601
CGG_MY35-AU,328,805.00,24,84.00,352,889.00,20140601
CGG_MY41-AU,1547,3030.30,109,311.00,1656,3341.30,20140601
CGG_MY42-AU,2081,3794.90,151,402.80,2232,4197.70,20140601
CGG_MY43-AU,922,2284.25,48,145.00,970,2429.25,20140601
CGG_MY44-AU,457,1199.90,29,97.00,486,1296.90,20140601
CGG_MY45-AU,891,2316.45,69,222.00,960,2538.45,20140601
CGG_MY46-AU,1583,4168.05,109,353.40,1692,4521.45,20140601
CGG_MY47-AU,1168,3008.95,78,241.60,1246,3250.55,20140601
CGG_MY51-AU,858,2552.20,90,395.00,948,2947.20,20140601
CGG_MY52-AU,934,3118.50,188,1144.60,1122,4263.10,20140601
CGG_MY53-AU,602,1901.25,52,242.00,654,2143.25,20140601
CGG_MY54-AU,794,2927.23,167,1080.00,961,4007.23,20140601
CGG_MY55-AU,993,3143.15,147,682.00,1140,3825.15,20140601
CGG_MY56-AU,935,3492.20,162,1029.20,1097,4521.40,20140601
CGG_MY57-AU,1014,3153.30,116,525.60,1130,3678.90,20140601
CGG_PNR1-AU,675,2035.90,202,606.00,877,2641.90,20140601
CGG_PNR2-AU,91,274.40,16,48.00,107,322.40,20140601
CGG_RBX4-AU,63,161.45,15,50.00,78,211.45,20140601
CGG_RBX5-AU,233,902.70,145,580.00,378,1482.70,20140601
CGG_RBX6-AU,337,1330.40,244,963.00,581,2293.40,20140601
CGG_RBX7-AU,240,906.50,185,740.00,425,1646.50,20140601
CGG_RS11-AU,644,928.65,34,106.20,678,1034.85,20140601
CGG_RS13-AU,450,587.00,39,111.40,489,698.40,20140601
CGG_RS14-AU,1223,1220.75,48,95.60,1271,1316.35,20140601
CGG_RS15-AU,647,1078.60,57,166.60,704,1245.20,20140601
CGG_RS16-AU,1144,1532.85,40,100.20,1184,1633.05,20140601
CGG_RS20-AU,1119,1529.80,62,176.60,1181,1706.40,20140601
CGG_RS21-AU,1245,1807.35,67,159.20,1312,1966.55,20140601
CGG_RS22-AU,1975,2723.40,112,299.80,2087,3023.20,20140601
CGG_RS23-AU,1391,1970.55,67,148.40,1458,2118.95,20140601
CGG_RS30-AU,1223,1851.50,71,172.40,1294,2023.90,20140601
CGG_RS31-AU,1288,2086.30,48,128.60,1336,2214.90,20140601
CGG_RS32-AU,834,1470.45,53,139.80,887,1610.25,20140601
CGG_RS33-AU,944,1710.95,69,172.80,1013,1883.75,20140601
CGG_RS41-AU,1125,1959.30,112,300.80,1237,2260.10,20140601
CGG_RS42-AU,1280,2554.65,86,238.80,1366,2793.45,20140601
CGG_RS43-AU,611,1101.60,67,198.20,678,1299.80,20140601
CGG_RS44-AU,423,860.85,31,88.60,454,949.45,20140601
CGG_RS45-AU,1259,2293.90,110,298.80,1369,2592.70,20140601
CGG_RS46-AU,706,1543.35,76,230.60,782,1773.95,20140601
CGG_RS50-AU,332,551.90,26,50.00,358,601.90,20140601
CGG_RS53-AU,761,1686.00,77,239.00,838,1925.00,20140601
CGG_RSX1-AU,377,489.25,11,32.20,388,521.45,20140601
CGG_RSX2-AU,581,1021.55,29,77.40,610,1098.95,20140601
CGG_RSX3-AU,431,861.55,34,110.60,465,972.15,20140601
CGG_RT12-AU,760,1694.85,79,351.60,839,2046.45,20140601
CGG_SS31-AU,635,1278.25,33,119.40,668,1397.65,20140601
CGG_SS32-AU,546,965.55,23,102.00,569,1067.55,20140601
CGG_SW30-AU,290,913.10,72,589.00,362,1502.10,20140601
CGG_SW31-AU,793,1901.50,77,251.00,870,2152.50,20140601
CGG_SW32-AU,325,1054.35,94,894.00,419,1948.35,20140601
CGG_SW33-AU,472,1203.90,58,193.60,530,1397.50,20140601
CGG_SW34-AU,431,1565.85,179,1936.00,610,3501.85,20140601
CGG_SW35-AU,874,2300.40,97,348.60,971,2649.00,20140601
CGG_TM10-AU,1480,3662.00,377,1368.00,1857,5030.00,20140601
CGG_TMX3-AU,895,2805.20,317,1867.00,1212,4672.20,20140601
CGG_TMX4-AU,1532,4647.25,361,1980.65,1893,6627.90,20140601
CGG_TMX5-AU,1530,4304.45,556,3333.60,2086,7638.05,20140601
CGG_TMX6-AU,1580,4823.70,574,3328.50,2154,8152.20,20140601
CGG_TMX7-AU,1113,2891.50,371,1393.40,1484,4284.90,20140601
CGG_TMX8-AU,1874,4896.80,920,3551.85,2794,8448.65,20140601
CGG_TMX9-AU,2037,4926.95,391,1379.45,2428,6306.40,20140601
CGG_TPX1-AU,1043,1863.25,153,440.00,1196,2303.25,20140601
CGG_US10-AU,939,1862.15,41,94.80,980,1956.95,20140601
CGG_WES1-AU,406,1635.85,101,561.45,507,2197.30,20140601
CGG_WES2-AU,565,2153.10,166,985.75,731,3138.85,20140601
CGG_YA11-AU,711,1261.80,27,69.60,738,1331.40,20140601
CGG_YA13-AU,1574,2566.00,86,219.80,1660,2785.80,20140601
CGG_YA14-AU,1122,1826.20,65,130.60,1187,1956.80,20140601
CGG_YA18-AU,902,1615.60,69,174.20,971,1789.80,20140601
CGG_YA20-AU,1323,2383.50,105,286.60,1428,2670.10,20140601
CGG_YA21-AU,966,1474.90,52,125.00,1018,1599.90,20140601
CGG_YA23-AU,705,1286.95,45,125.60,750,1412.55,20140601
CGG_YA31-AU,1371,2875.75,110,314.00,1481,3189.75,20140601
CGG_YA32-AU,947,1901.45,59,163.40,1006,2064.85,20140601
CGG_YA34-AU,771,1812.50,79,336.20,850,2148.70,20140601
CGG_YA35-AU,876,2280.85,75,343.00,951,2623.85,20140601
CGG_YA36-AU,545,1321.15,58,253.60,603,1574.75,20140601
CGG_YAX1-AU,451,1173.35,77,295.00,528,1468.35,20140601
CGG_YAX2-AU,431,1024.45,41,128.60,472,1153.05,20140601
CGG_YAX3-AU,148,388.05,15,59.00,163,447.05,20140601
CGG_YAX4-AU,239,571.80,31,138.60,270,710.40,20140601
CGG_YCX1-AU,262,598.45,23,107.00,285,705.45,20140601
CGG_AP21-AU,519,1070.60,76,267.20,595,1337.80,20140501
CGG_BC21-AU,263,1059.65,152,1662.15,415,2721.80,20140501
CGG_BC41-AU,244,818.05,166,803.60,410,1621.65,20140501
CGG_BC42-AU,105,438.60,54,268.00,159,706.60,20140501
CGG_BC43-AU,231,911.25,256,1269.00,487,2180.25,20140501
CGG_BR22-AU,575,1236.60,148,493.20,723,1729.80,20140501
CGG_BR23-AU,688,1798.00,169,791.40,857,2589.40,20140501
CGG_BR26-AU,890,1722.25,119,361.20,1009,2083.45,20140501
CGG_BR31-AU,860,1971.70,85,400.00,945,2371.70,20140501
CGG_BR32-AU,755,1415.25,36,96.60,791,1511.85,20140501
CGG_BR33-AU,334,721.65,36,173.00,370,894.65,20140501
CGG_BR34-AU,1452,2486.40,69,163.40,1521,2649.80,20140501
CGG_BR35-AU,824,1816.35,96,391.20,920,2207.55,20140501
CGG_BR41-AU,162,576.35,142,704.00,304,1280.35,20140501
CGG_BR42-AU,581,1289.05,135,501.20,716,1790.25,20140501
CGG_BR43-AU,135,582.30,93,465.00,228,1047.30,20140501
CGG_BR44-AU,335,824.95,9,34.00,344,858.95,20140501
CGG_BR45-AU,96,425.85,84,418.00,180,843.85,20140501
CGG_BS11-AU,185,856.30,160,800.00,345,1656.30,20140501
CGG_BS12-AU,330,860.25,60,267.00,390,1127.25,20140501
CGG_BS13-AU,125,580.80,140,700.00,265,1280.80,20140501
CGG_BS16-AU,70,316.25,43,211.00,113,527.25,20140501
CGG_BS17-AU,409,1032.25,54,447.00,463,1479.25,20140501
CGG_BS18-AU,419,998.15,93,438.00,512,1436.15,20140501
CGG_BS21-AU,1370,2667.05,91,251.40,1461,2918.45,20140501
CGG_BS22-AU,978,1631.00,51,128.20,1029,1759.20,20140501
CGG_BS23-AU,1101,2226.65,82,241.40,1183,2468.05,20140501
CGG_BS24-AU,1177,2211.35,68,191.20,1245,2402.55,20140501
CGG_BS25-AU,1424,2968.05,93,262.60,1517,3230.65,20140501
CGG_BS26-AU,1846,3863.75,133,350.00,1979,4213.75,20140501
CGG_BS27-AU,2246,5051.30,155,454.20,2401,5505.50,20140501
CGG_BS29-AU,885,2246.30,47,151.20,932,2397.50,20140501
CGG_BS31-AU,720,1754.70,56,176.00,776,1930.70,20140501
CGG_BS32-AU,1139,2714.55,75,232.80,1214,2947.35,20140501
CGG_BS34-AU,145,359.15,3,7.00,148,366.15,20140501
CGG_BS35-AU,689,1702.10,55,172.60,744,1874.70,20140501
CGG_BS36-AU,1750,4378.80,117,375.20,1867,4754.00,20140501
CGG_BS37-AU,1680,4227.10,160,533.20,1840,4760.30,20140501
CGG_CCX1-AU,181,1133.90,243,3194.00,424,4327.90,20140501
CGG_CCX2-AU,271,1711.35,223,2516.80,494,4228.15,20140501
CGG_CCX3-AU,85,456.10,54,519.50,139,975.60,20140501
CGG_CCX4-AU,59,355.45,79,785.50,138,1140.95,20140501
CGG_CCX5-AU,295,2273.70,239,2956.10,534,5229.80,20140501
CGG_CCX6-AU,38,236.00,113,1661.40,151,1897.40,20140501
CGG_CL11-AU,844,1750.25,86,261.80,930,2012.05,20140501
CGG_CLX2-AU,789,1492.15,88,268.40,877,1760.55,20140501
CGG_CPX1-AU,1705,4853.10,194,794.40,1899,5647.50,20140501
CGG_CPX2-AU,1023,2977.90,127,533.00,1150,3510.90,20140501
CGG_CS21-AU,923,2516.40,187,825.40,1110,3341.80,20140501
CGG_CS22-AU,781,1603.10,80,239.00,861,1842.10,20140501
CGG_EB29-AU,397,1023.75,28,104.00,425,1127.75,20140501
CGG_EB31-AU,679,1701.35,32,116.20,711,1817.55,20140501
CGG_EB32-AU,698,1628.65,74,312.00,772,1940.65,20140501
CGG_EB33-AU,1354,3234.10,91,331.00,1445,3565.10,20140501
CGG_EB34-AU,952,1920.65,61,221.60,1013,2142.25,20140501
CGG_EB35-AU,960,2487.25,87,348.00,1047,2835.25,20140501
CGG_EB36-AU,1097,2672.55,120,455.20,1217,3127.75,20140501
CGG_EB41-AU,628,1677.40,48,293.00,676,1970.40,20140501
CGG_EB42-AU,130,509.75,98,483.00,228,992.75,20140501
CGG_EB44-AU,85,364.60,140,689.00,225,1053.60,20140501
CGG_EB46-AU,90,313.70,133,643.20,223,956.90,20140501
CGG_FM21-AU,476,2193.30,234,2429.75,710,4623.05,20140501
CGG_FM22-AU,393,1865.10,258,2576.40,651,4441.50,20140501
CGG_FM23-AU,278,1217.60,283,2992.15,561,4209.75,20140501
CGG_FM24-AU,276,1257.20,262,2945.25,538,4202.45,20140501
CGG_FS21-AU,222,928.75,141,1564.65,363,2493.40,20140501
CGG_FS22-AU,398,1142.05,107,521.20,505,1663.25,20140501
CGG_FS23-AU,120,531.35,113,1403.15,233,1934.50,20140501
CGG_FS24-AU,216,666.15,36,176.00,252,842.15,20140501
CGG_FS25-AU,327,974.30,110,582.00,437,1556.30,20140501
CGG_FS26-AU,332,1147.75,96,495.60,428,1643.35,20140501
CGG_FS31-AU,865,1606.80,60,205.00,925,1811.80,20140501
CGG_FS32-AU,978,1998.25,113,366.20,1091,2364.45,20140501
CGG_FS33-AU,1504,2555.35,84,248.60,1588,2803.95,20140501
CGG_GC13-AU,224,877.90,122,591.00,346,1468.90,20140501
CGG_GH15-AU,221,570.95,51,192.20,272,763.15,20140501
CGG_GH21-AU,484,771.70,48,136.80,532,908.50,20140501
CGG_GH23-AU,1095,1766.45,81,204.80,1176,1971.25,20140501
CGG_GH24-AU,1433,2319.70,129,342.00,1562,2661.70,20140501
CGG_GH31-AU,1362,2148.20,126,364.60,1488,2512.80,20140501
CGG_GH32-AU,1217,1994.30,96,264.20,1313,2258.50,20140501
CGG_GH33-AU,845,1817.20,5,23.00,850,1840.20,20140501
CGG_GH34-AU,964,2011.05,69,206.60,1033,2217.65,20140501
CGG_GH36-AU,1308,2613.00,59,164.60,1367,2777.60,20140501
CGG_GHX1-AU,1051,3274.65,307,1445.40,1358,4720.05,20140501
CGG_GHX3-AU,738,2186.85,165,784.40,903,2971.25,20140501
CGG_GHX5-AU,816,2522.50,211,968.80,1027,3491.30,20140501
CGG_GM11-AU,217,662.90,59,210.20,276,873.10,20140501
CGG_GM16-AU,216,579.00,41,148.60,257,727.60,20140501
CGG_HAY1-AU,468,2979.90,694,5162.95,1162,8142.85,20140501
CGG_HAY2-AU,701,4277.30,741,5459.95,1442,9737.25,20140501
CGG_HAY3-AU,1049,5385.75,1011,7416.15,2060,12801.90,20140501
CGG_JSX1-AU,1060,2064.90,127,351.60,1187,2416.50,20140501
CGG_JSX2-AU,1356,2462.15,118,308.00,1474,2770.15,20140501
CGG_LM11-AU,1032,1956.05,104,351.20,1136,2307.25,20140501
CGG_LM12-AU,895,1363.50,72,204.60,967,1568.10,20140501
CGG_LM13-AU,0,0.00,0,0.00,0,0.00,20140501
CGG_LM14-AU,569,866.25,40,119.60,609,985.85,20140501
CGG_LM15-AU,683,1260.25,27,69.20,710,1329.45,20140501
CGG_LM16-AU,744,1490.00,105,318.60,849,1808.60,20140501
CGG_LM30-AU,1107,1587.95,52,117.60,1159,1705.55,20140501
CGG_LM32-AU,1870,2761.20,92,205.40,1962,2966.60,20140501
CGG_LM41-AU,1149,1658.60,47,98.40,1196,1757.00,20140501
CGG_LM42-AU,1054,1554.35,58,141.00,1112,1695.35,20140501
CGG_LM43-AU,1707,1980.80,59,123.60,1766,2104.40,20140501
CGG_LM44-AU,1787,2494.55,93,234.60,1880,2729.15,20140501
CGG_LMX2-AU,288,1396.75,194,1715.70,482,3112.45,20140501
CGG_LR11-AU,788,1445.35,57,163.60,845,1608.95,20140501
CGG_LR12-AU,1167,2083.95,80,209.00,1247,2292.95,20140501
CGG_LR13-AU,1949,3582.00,123,334.00,2072,3916.00,20140501
CGG_LR14-AU,941,1724.35,49,117.40,990,1841.75,20140501
CGG_LR15-AU,205,761.65,92,440.00,297,1201.65,20140501
CGG_LR16-AU,896,1800.60,133,416.60,1029,2217.20,20140501
CGG_LR31-AU,363,899.45,58,201.60,421,1101.05,20140501
CGG_LR33-AU,451,1074.05,58,260.20,509,1334.25,20140501
CGG_LR43-AU,843,2068.35,81,276.20,924,2344.55,20140501
CGG_LR47-AU,1229,3312.95,117,444.20,1346,3757.15,20140501
CGG_MB11-AU,864,1545.25,49,128.80,913,1674.05,20140501
CGG_MB12-AU,1286,2287.50,65,181.40,1351,2468.90,20140501
CGG_MB13-AU,759,1303.10,41,112.80,800,1415.90,20140501
CGG_MB14-AU,869,1349.75,42,101.00,911,1450.75,20140501
CGG_MB15-AU,596,931.00,31,70.80,627,1001.80,20140501
CGG_MB16-AU,806,1311.25,65,163.40,871,1474.65,20140501
CGG_MB17-AU,1134,1780.70,109,324.60,1243,2105.30,20140501
CGG_MB23-AU,1514,2231.65,61,143.20,1575,2374.85,20140501
CGG_MB31-AU,2114,2857.10,102,251.20,2216,3108.30,20140501
CGG_MB32-AU,1861,2316.10,81,155.00,1942,2471.10,20140501
CGG_MB33-AU,1816,2595.45,80,196.20,1896,2791.65,20140501
CGG_MB34-AU,1519,1952.25,42,100.60,1561,2052.85,20140501
CGG_MB35-AU,1243,2234.50,113,368.20,1356,2602.70,20140501
CGG_MB36-AU,2207,3060.95,109,284.00,2316,3344.95,20140501
CGG_MB37-AU,1084,1710.90,94,296.80,1178,2007.70,20140501
CGG_MB38-AU,1893,2844.65,60,150.80,1953,2995.45,20140501
CGG_MB41-AU,1445,2286.40,74,189.40,1519,2475.80,20140501
CGG_MB42-AU,410,822.90,20,64.00,430,886.90,20140501
CGG_MB44-AU,1162,2149.85,81,237.60,1243,2387.45,20140501
CGG_MBX1-AU,1210,2712.90,100,315.60,1310,3028.50,20140501
CGG_MBX2-AU,1126,2473.20,79,233.00,1205,2706.20,20140501
CGG_MBX4-AU,867,1901.65,79,252.80,946,2154.45,20140501
CGG_MC21-AU,1261,3036.00,135,955.60,1396,3991.60,20140501
CGG_MC22-AU,1097,2410.15,97,540.20,1194,2950.35,20140501
CGG_MC23-AU,1341,3034.40,98,515.50,1439,3549.90,20140501
CGG_MK31-AU,219,642.25,31,149.00,250,791.25,20140501
CGG_MK34-AU,217,578.30,39,182.60,256,760.90,20140501
CGG_MK35-AU,143,348.25,24,105.00,167,453.25,20140501
CGG_MM41-AU,2016,2954.65,108,258.80,2124,3213.45,20140501
CGG_MS10-AU,568,814.20,35,82.80,603,897.00,20140501
CGG_MS11-AU,1159,1900.75,74,187.00,1233,2087.75,20140501
CGG_MS12-AU,1714,2422.70,83,205.00,1797,2627.70,20140501
CGG_MS21-AU,1743,2681.70,89,208.80,1832,2890.50,20140501
CGG_MS30-AU,667,956.45,58,130.40,725,1086.85,20140501
CGG_MS31-AU,2363,3853.90,111,266.40,2474,4120.30,20140501
CGG_MS32-AU,1410,2132.70,103,248.60,1513,2381.30,20140501
CGG_MS41-AU,1065,1599.65,53,101.20,1118,1700.85,20140501
CGG_MS42-AU,1875,2270.70,104,156.40,1979,2427.10,20140501
CGG_MS43-AU,1876,2720.60,120,312.60,1996,3033.20,20140501
CGG_MS44-AU,1614,2022.65,65,115.00,1679,2137.65,20140501
CGG_MS46-AU,1407,1727.60,73,172.60,1480,1900.20,20140501
CGG_MY21-AU,1056,1906.30,28,73.80,1084,1980.10,20140501
CGG_MY22-AU,1318,2823.85,74,200.00,1392,3023.85,20140501
CGG_MY23-AU,672,1290.45,32,77.00,704,1367.45,20140501
CGG_MY25-AU,1239,2378.80,48,113.80,1287,2492.60,20140501
CGG_MY31-AU,553,1149.60,95,314.80,648,1464.40,20140501
CGG_MY32-AU,750,1542.20,66,216.20,816,1758.40,20140501
CGG_MY33-AU,378,908.55,36,120.00,414,1028.55,20140501
CGG_MY34-AU,504,1240.80,41,137.60,545,1378.40,20140501
CGG_MY35-AU,386,961.85,44,151.00,430,1112.85,20140501
CGG_MY41-AU,1953,3780.05,139,380.80,2092,4160.85,20140501
CGG_MY42-AU,2435,4359.30,135,358.60,2570,4717.90,20140501
CGG_MY43-AU,1072,2682.65,71,226.60,1143,2909.25,20140501
CGG_MY44-AU,537,1359.40,30,94.00,567,1453.40,20140501
CGG_MY45-AU,933,2491.95,91,307.20,1024,2799.15,20140501
CGG_MY46-AU,1885,5115.05,143,486.20,2028,5601.25,20140501
CGG_MY47-AU,1347,3530.10,107,333.40,1454,3863.50,20140501
CGG_MY51-AU,1024,3045.30,137,623.60,1161,3668.90,20140501
CGG_MY52-AU,966,3060.70,224,1379.80,1190,4440.50,20140501
CGG_MY53-AU,701,2099.00,94,396.60,795,2495.60,20140501
CGG_MY54-AU,971,3370.85,204,1220.60,1175,4591.45,20140501
CGG_MY55-AU,1151,3560.60,152,699.00,1303,4259.60,20140501
CGG_MY56-AU,1203,4349.90,173,998.00,1376,5347.90,20140501
CGG_MY57-AU,1153,3565.10,180,795.20,1333,4360.30,20140501
CGG_PNR1-AU,908,2735.25,221,663.00,1129,3398.25,20140501
CGG_PNR2-AU,108,325.10,11,33.00,119,358.10,20140501
CGG_RBX4-AU,162,468.05,43,171.00,205,639.05,20140501
CGG_RBX5-AU,346,1362.35,204,813.00,550,2175.35,20140501
CGG_RBX6-AU,381,1489.20,293,1168.00,674,2657.20,20140501
CGG_RBX7-AU,290,1106.50,204,808.00,494,1914.50,20140501
CGG_RS11-AU,710,973.70,46,132.60,756,1106.30,20140501
CGG_RS13-AU,586,845.35,36,96.60,622,941.95,20140501
CGG_RS14-AU,1430,1432.50,39,90.60,1469,1523.10,20140501
CGG_RS15-AU,708,1242.60,91,278.00,799,1520.60,20140501
CGG_RS16-AU,1360,1777.90,55,137.60,1415,1915.50,20140501
CGG_RS20-AU,1346,1964.20,73,167.20,1419,2131.40,20140501
CGG_RS21-AU,1538,2212.35,94,221.00,1632,2433.35,20140501
CGG_RS22-AU,2466,3329.90,108,234.60,2574,3564.50,20140501
CGG_RS23-AU,1565,2106.50,70,165.20,1635,2271.70,20140501
CGG_RS30-AU,1410,2089.15,64,160.00,1474,2249.15,20140501
CGG_RS31-AU,1618,2691.20,60,153.80,1678,2845.00,20140501
CGG_RS32-AU,1082,1810.00,76,207.40,1158,2017.40,20140501
CGG_RS33-AU,1178,2027.90,58,144.00,1236,2171.90,20140501
CGG_RS41-AU,1366,2367.65,127,339.00,1493,2706.65,20140501
CGG_RS42-AU,1427,2820.25,97,280.00,1524,3100.25,20140501
CGG_RS43-AU,686,1236.75,66,179.20,752,1415.95,20140501
CGG_RS44-AU,579,1188.75,40,129.60,619,1318.35,20140501
CGG_RS45-AU,1365,2481.75,150,440.40,1515,2922.15,20140501
CGG_RS46-AU,877,1845.90,77,233.60,954,2079.50,20140501
CGG_RS50-AU,510,887.85,33,62.60,543,950.45,20140501
CGG_RS53-AU,895,1948.00,82,250.60,977,2198.60,20140501
CGG_RSX1-AU,461,586.60,12,25.40,473,612.00,20140501
CGG_RSX2-AU,686,1155.50,42,124.20,728,1279.70,20140501
CGG_RSX3-AU,522,1050.55,39,122.00,561,1172.55,20140501
CGG_RT12-AU,1208,2887.05,122,506.20,1330,3393.25,20140501
CGG_SS31-AU,746,1372.50,79,329.20,825,1701.70,20140501
CGG_SS32-AU,616,1221.05,39,158.20,655,1379.25,20140501
CGG_SW30-AU,320,911.10,81,635.00,401,1546.10,20140501
CGG_SW31-AU,1095,2598.40,114,371.00,1209,2969.40,20140501
CGG_SW32-AU,306,1069.25,112,1197.00,418,2266.25,20140501
CGG_SW33-AU,653,1667.75,69,232.00,722,1899.75,20140501
CGG_SW34-AU,513,1812.50,217,2236.00,730,4048.50,20140501
CGG_SW35-AU,997,2599.90,89,311.00,1086,2910.90,20140501
CGG_TM10-AU,1806,4401.90,492,1855.10,2298,6257.00,20140501
CGG_TMX3-AU,970,2916.25,370,2217.90,1340,5134.15,20140501
CGG_TMX4-AU,1762,5254.05,401,2219.70,2163,7473.75,20140501
CGG_TMX5-AU,1755,4909.30,631,3791.85,2386,8701.15,20140501
CGG_TMX6-AU,1733,5293.20,663,3987.65,2396,9280.85,20140501
CGG_TMX7-AU,1259,3297.95,422,1593.45,1681,4891.40,20140501
CGG_TMX8-AU,2088,5496.95,1130,4379.25,3218,9876.20,20140501
CGG_TMX9-AU,2330,5596.25,427,1565.40,2757,7161.65,20140501
CGG_TPX1-AU,1150,2194.05,148,447.95,1298,2642.00,20140501
CGG_US10-AU,1072,1892.40,54,133.40,1126,2025.80,20140501
CGG_WES1-AU,428,1634.75,99,534.85,527,2169.60,20140501
CGG_WES2-AU,660,2356.10,140,780.20,800,3136.30,20140501
CGG_YA11-AU,805,1345.90,31,77.00,836,1422.90,20140501
CGG_YA13-AU,1969,3111.00,98,214.80,2067,3325.80,20140501
CGG_YA14-AU,1397,2182.25,56,124.00,1453,2306.25,20140501
CGG_YA18-AU,1051,1795.00,69,179.00,1120,1974.00,20140501
CGG_YA20-AU,1545,2650.90,109,292.80,1654,2943.70,20140501
CGG_YA21-AU,1125,1745.10,64,162.60,1189,1907.70,20140501
CGG_YA23-AU,868,1472.40,63,171.00,931,1643.40,20140501
CGG_YA31-AU,1533,3091.70,133,367.00,1666,3458.70,20140501
CGG_YA32-AU,1032,1975.15,49,128.80,1081,2103.95,20140501
CGG_YA34-AU,830,1986.35,77,310.20,907,2296.55,20140501
CGG_YA35-AU,992,2553.25,126,491.60,1118,3044.85,20140501
CGG_YA36-AU,587,1463.30,70,298.20,657,1761.50,20140501
CGG_YAX1-AU,584,1487.80,57,233.00,641,1720.80,20140501
CGG_YAX2-AU,567,1455.75,68,252.00,635,1707.75,20140501
CGG_YAX3-AU,219,567.20,30,123.00,249,690.20,20140501
CGG_YAX4-AU,303,798.15,40,177.60,343,975.75,20140501
CGG_YCX1-AU,393,909.30,39,156.00,432,1065.30,20140501
CGG_AP21-AU,434,970.85,67,242.20,501,1213.05,20140401
CGG_BC21-AU,330,1300.70,131,1365.15,461,2665.85,20140401
CGG_BC41-AU,274,960.20,151,732.00,425,1692.20,20140401
CGG_BC42-AU,124,463.75,77,376.60,201,840.35,20140401
CGG_BC43-AU,204,707.50,237,1173.60,441,1881.10,20140401
CGG_BR22-AU,623,1453.20,105,344.60,728,1797.80,20140401
CGG_BR23-AU,653,1771.50,150,684.20,803,2455.70,20140401
CGG_BR26-AU,755,1603.75,103,326.80,858,1930.55,20140401
CGG_BR31-AU,839,2025.50,79,338.60,918,2364.10,20140401
CGG_BR32-AU,813,1542.85,17,40.60,830,1583.45,20140401
CGG_BR33-AU,302,675.55,16,67.60,318,743.15,20140401
CGG_BR34-AU,1389,2520.05,59,156.40,1448,2676.45,20140401
CGG_BR35-AU,804,1880.10,55,227.60,859,2107.70,20140401
CGG_BR41-AU,136,546.95,94,461.60,230,1008.55,20140401
CGG_BR42-AU,597,1401.05,101,367.60,698,1768.65,20140401
CGG_BR43-AU,96,394.10,69,345.00,165,739.10,20140401
CGG_BR44-AU,344,833.20,8,24.00,352,857.20,20140401
CGG_BR45-AU,97,413.10,124,604.00,221,1017.10,20140401
CGG_BS11-AU,170,805.50,147,734.00,317,1539.50,20140401
CGG_BS12-AU,381,1000.65,52,221.60,433,1222.25,20140401
CGG_BS13-AU,127,578.75,124,618.00,251,1196.75,20140401
CGG_BS16-AU,125,527.05,66,325.00,191,852.05,20140401
CGG_BS17-AU,493,1370.05,63,571.00,556,1941.05,20140401
CGG_BS18-AU,408,992.10,75,339.00,483,1331.10,20140401
CGG_BS21-AU,1367,2697.95,71,198.20,1438,2896.15,20140401
CGG_BS22-AU,958,1636.20,46,117.20,1004,1753.40,20140401
CGG_BS23-AU,1060,2049.10,57,155.60,1117,2204.70,20140401
CGG_BS24-AU,1134,2120.45,65,182.60,1199,2303.05,20140401
CGG_BS25-AU,1405,2874.20,73,206.20,1478,3080.40,20140401
CGG_BS26-AU,1742,3560.55,99,290.00,1841,3850.55,20140401
CGG_BS27-AU,2058,4638.10,145,427.80,2203,5065.90,20140401
CGG_BS29-AU,822,2061.45,47,145.20,869,2206.65,20140401
CGG_BS31-AU,667,1550.45,36,110.20,703,1660.65,20140401
CGG_BS32-AU,1029,2401.60,57,175.60,1086,2577.20,20140401
CGG_BS34-AU,136,363.65,8,18.20,144,381.85,20140401
CGG_BS35-AU,733,1779.75,48,162.00,781,1941.75,20140401
CGG_BS36-AU,1782,4428.90,101,323.20,1883,4752.10,20140401
CGG_BS37-AU,1577,3840.85,113,367.20,1690,4208.05,20140401
CGG_CCX1-AU,165,953.75,208,2494.00,373,3447.75,20140401
CGG_CCX2-AU,275,1800.35,158,1761.60,433,3561.95,20140401
CGG_CCX3-AU,64,357.65,50,489.70,114,847.35,20140401
CGG_CCX4-AU,68,369.00,53,536.00,121,905.00,20140401
CGG_CCX5-AU,271,2172.30,186,2084.00,457,4256.30,20140401
CGG_CCX6-AU,55,327.45,78,982.90,133,1310.35,20140401
CGG_CL11-AU,816,1767.35,74,239.60,890,2006.95,20140401
CGG_CLX2-AU,920,1774.00,63,198.60,983,1972.60,20140401
CGG_CPX1-AU,1927,5788.70,274,1146.20,2201,6934.90,20140401
CGG_CPX2-AU,1261,3969.85,193,824.40,1454,4794.25,20140401
CGG_CS21-AU,845,2248.85,188,859.60,1033,3108.45,20140401
CGG_CS22-AU,729,1443.05,75,223.80,804,1666.85,20140401
CGG_EB29-AU,373,1038.90,41,170.00,414,1208.90,20140401
CGG_EB31-AU,593,1519.55,60,226.60,653,1746.15,20140401
CGG_EB32-AU,704,1725.55,81,360.00,785,2085.55,20140401
CGG_EB33-AU,1337,3278.40,138,509.80,1475,3788.20,20140401
CGG_EB34-AU,918,2004.85,68,242.20,986,2247.05,20140401
CGG_EB35-AU,1102,2882.75,98,362.80,1200,3245.55,20140401
CGG_EB36-AU,1091,2712.60,101,407.40,1192,3120.00,20140401
CGG_EB41-AU,638,1897.70,68,425.00,706,2322.70,20140401
CGG_EB42-AU,97,402.05,100,499.00,197,901.05,20140401
CGG_EB44-AU,101,407.70,119,595.00,220,1002.70,20140401
CGG_EB46-AU,101,418.85,82,403.60,183,822.45,20140401
CGG_FM21-AU,487,1670.05,154,1572.85,641,3242.90,20140401
CGG_FM22-AU,343,1427.60,149,1560.85,492,2988.45,20140401
CGG_FM23-AU,280,1208.85,201,2153.90,481,3362.75,20140401
CGG_FM24-AU,258,1148.35,214,2301.15,472,3449.50,20140401
CGG_FS21-AU,273,945.15,87,819.85,360,1765.00,20140401
CGG_FS22-AU,286,744.25,62,286.20,348,1030.45,20140401
CGG_FS23-AU,128,552.40,88,1073.50,216,1625.90,20140401
CGG_FS24-AU,266,746.50,42,206.60,308,953.10,20140401
CGG_FS25-AU,297,837.80,83,385.60,380,1223.40,20140401
CGG_FS26-AU,293,927.70,72,359.60,365,1287.30,20140401
CGG_FS31-AU,743,1366.10,59,177.60,802,1543.70,20140401
CGG_FS32-AU,835,1658.45,82,259.80,917,1918.25,20140401
CGG_FS33-AU,1381,2311.65,77,228.80,1458,2540.45,20140401
CGG_GC13-AU,237,920.50,96,466.00,333,1386.50,20140401
CGG_GH15-AU,257,602.10,55,205.00,312,807.10,20140401
CGG_GH21-AU,422,736.85,62,218.00,484,954.85,20140401
CGG_GH23-AU,942,1566.00,82,203.80,1024,1769.80,20140401
CGG_GH24-AU,1656,2739.45,106,277.20,1762,3016.65,20140401
CGG_GH31-AU,1497,2492.35,78,189.40,1575,2681.75,20140401
CGG_GH32-AU,1202,2041.90,103,294.80,1305,2336.70,20140401
CGG_GH33-AU,877,1882.55,15,58.60,892,1941.15,20140401
CGG_GH34-AU,856,1760.20,63,181.20,919,1941.40,20140401
CGG_GH36-AU,1159,2340.25,42,112.80,1201,2453.05,20140401
CGG_GHX1-AU,1041,3420.40,230,1058.40,1271,4478.80,20140401
CGG_GHX3-AU,685,2168.45,160,735.40,845,2903.85,20140401
CGG_GHX5-AU,687,2406.00,156,724.60,843,3130.60,20140401
CGG_GM11-AU,214,652.40,49,177.00,263,829.40,20140401
CGG_GM16-AU,197,494.00,21,73.60,218,567.60,20140401
CGG_HAY1-AU,361,2051.90,491,3636.00,852,5687.90,20140401
CGG_HAY2-AU,559,3420.60,560,4142.70,1119,7563.30,20140401
CGG_HAY3-AU,1280,6626.30,1052,7625.55,2332,14251.85,20140401
CGG_JSX1-AU,1108,2134.60,97,273.80,1205,2408.40,20140401
CGG_JSX2-AU,1284,2354.55,109,311.20,1393,2665.75,20140401
CGG_LM11-AU,908,1636.65,85,257.60,993,1894.25,20140401
CGG_LM12-AU,867,1281.25,64,177.60,931,1458.85,20140401
CGG_LM13-AU,0,0.00,0,0.00,0,0.00,20140401
CGG_LM14-AU,554,852.55,54,166.00,608,1018.55,20140401
CGG_LM15-AU,663,1249.80,33,108.60,696,1358.40,20140401
CGG_LM16-AU,818,1543.15,75,220.40,893,1763.55,20140401
CGG_LM30-AU,1024,1474.30,42,96.20,1066,1570.50,20140401
CGG_LM32-AU,1796,2752.70,72,152.40,1868,2905.10,20140401
CGG_LM41-AU,1016,1554.40,41,87.60,1057,1642.00,20140401
CGG_LM42-AU,981,1483.50,37,87.80,1018,1571.30,20140401
CGG_LM43-AU,1490,1831.15,37,79.60,1527,1910.75,20140401
CGG_LM44-AU,1673,2337.55,83,202.40,1756,2539.95,20140401
CGG_LMX2-AU,277,1218.15,123,1107.00,400,2325.15,20140401
CGG_LR11-AU,616,1186.45,60,168.20,676,1354.65,20140401
CGG_LR12-AU,1151,2093.90,61,151.80,1212,2245.70,20140401
CGG_LR13-AU,1864,3517.60,133,369.40,1997,3887.00,20140401
CGG_LR14-AU,844,1478.20,38,103.00,882,1581.20,20140401
CGG_LR15-AU,193,731.35,65,325.00,258,1056.35,20140401
CGG_LR16-AU,906,1807.70,88,271.40,994,2079.10,20140401
CGG_LR31-AU,338,900.70,56,233.60,394,1134.30,20140401
CGG_LR33-AU,628,1750.95,85,394.00,713,2144.95,20140401
CGG_LR43-AU,724,1797.40,58,212.00,782,2009.40,20140401
CGG_LR47-AU,1145,3152.25,90,388.60,1235,3540.85,20140401
CGG_MB11-AU,894,1601.95,44,127.20,938,1729.15,20140401
CGG_MB12-AU,1225,2209.40,81,234.40,1306,2443.80,20140401
CGG_MB13-AU,685,1223.90,28,80.20,713,1304.10,20140401
CGG_MB14-AU,735,1231.45,41,94.00,776,1325.45,20140401
CGG_MB15-AU,579,911.70,32,75.80,611,987.50,20140401
CGG_MB16-AU,786,1266.40,31,71.40,817,1337.80,20140401
CGG_MB17-AU,1087,1664.25,84,238.80,1171,1903.05,20140401
CGG_MB23-AU,1405,2184.15,42,93.40,1447,2277.55,20140401
CGG_MB31-AU,1882,2647.99,89,225.60,1971,2873.59,20140401
CGG_MB32-AU,1740,2307.95,69,123.60,1809,2431.55,20140401
CGG_MB33-AU,1752,2677.25,75,187.80,1827,2865.05,20140401
CGG_MB34-AU,1669,2215.65,52,101.40,1721,2317.05,20140401
CGG_MB35-AU,1251,2108.05,87,253.80,1338,2361.85,20140401
CGG_MB36-AU,2395,3393.85,90,203.80,2485,3597.65,20140401
CGG_MB37-AU,1381,2280.30,98,292.20,1479,2572.50,20140401
CGG_MB38-AU,1895,2847.70,68,168.80,1963,3016.50,20140401
CGG_MB41-AU,1630,2694.65,86,218.40,1716,2913.05,20140401
CGG_MB42-AU,1247,2552.15,77,240.80,1324,2792.95,20140401
CGG_MB44-AU,1343,2727.50,81,252.00,1424,2979.50,20140401
CGG_MBX1-AU,1279,2945.20,70,222.60,1349,3167.80,20140401
CGG_MBX2-AU,1101,2505.75,95,292.00,1196,2797.75,20140401
CGG_MBX4-AU,813,1810.30,53,161.20,866,1971.50,20140401
CGG_MC21-AU,890,2297.85,103,827.00,993,3124.85,20140401
CGG_MC22-AU,756,1740.80,86,624.40,842,2365.20,20140401
CGG_MC23-AU,902,2194.50,98,727.35,1000,2921.85,20140401
CGG_MK31-AU,311,1035.80,44,209.60,355,1245.40,20140401
CGG_MK34-AU,227,618.40,39,165.00,266,783.40,20140401
CGG_MK35-AU,158,440.80,49,212.00,207,652.80,20140401
CGG_MM41-AU,1804,2661.35,74,174.80,1878,2836.15,20140401
CGG_MS10-AU,592,801.80,26,68.40,618,870.20,20140401
CGG_MS11-AU,1171,1934.65,66,182.40,1237,2117.05,20140401
CGG_MS12-AU,1570,2227.70,71,175.60,1641,2403.30,20140401
CGG_MS21-AU,1473,2347.20,71,145.00,1544,2492.20,20140401
CGG_MS30-AU,684,1102.20,51,141.40,735,1243.60,20140401
CGG_MS31-AU,1923,3108.65,96,221.60,2019,3330.25,20140401
CGG_MS32-AU,1222,2009.45,79,191.20,1301,2200.65,20140401
CGG_MS41-AU,970,1516.85,41,75.00,1011,1591.85,20140401
CGG_MS42-AU,1682,2054.40,104,186.00,1786,2240.40,20140401
CGG_MS43-AU,1830,2633.80,88,227.00,1918,2860.80,20140401
CGG_MS44-AU,1500,1891.80,47,87.00,1547,1978.80,20140401
CGG_MS46-AU,1292,1629.30,47,92.40,1339,1721.70,20140401
CGG_MY21-AU,916,1573.95,35,103.40,951,1677.35,20140401
CGG_MY22-AU,477,995.60,29,91.20,506,1086.80,20140401
CGG_MY23-AU,786,1485.30,48,134.20,834,1619.50,20140401
CGG_MY24-AU,0,0.00,0,0.00,0,0.00,20140401
CGG_MY25-AU,1090,2004.45,56,166.00,1146,2170.45,20140401
CGG_MY31-AU,549,1179.60,67,246.00,616,1425.60,20140401
CGG_MY32-AU,794,1685.15,69,229.20,863,1914.35,20140401
CGG_MY33-AU,430,1092.75,35,102.80,465,1195.55,20140401
CGG_MY34-AU,530,1410.15,39,138.00,569,1548.15,20140401
CGG_MY35-AU,378,918.25,38,125.00,416,1043.25,20140401
CGG_MY41-AU,1847,3597.20,122,359.20,1969,3956.40,20140401
CGG_MY42-AU,2396,4308.90,119,295.20,2515,4604.10,20140401
CGG_MY43-AU,1051,2572.05,45,137.60,1096,2709.65,20140401
CGG_MY44-AU,509,1268.15,17,52.60,526,1320.75,20140401
CGG_MY45-AU,895,2363.55,58,173.80,953,2537.35,20140401
CGG_MY46-AU,1796,4691.85,122,402.80,1918,5094.65,20140401
CGG_MY47-AU,1285,3283.90,89,287.20,1374,3571.10,20140401
CGG_MY51-AU,975,2932.10,113,510.00,1088,3442.10,20140401
CGG_MY52-AU,921,2996.65,188,1172.00,1109,4168.65,20140401
CGG_MY53-AU,700,2057.15,78,344.00,778,2401.15,20140401
CGG_MY54-AU,1046,3852.25,174,1063.20,1220,4915.45,20140401
CGG_MY55-AU,1141,3365.95,109,447.60,1250,3813.55,20140401
CGG_MY56-AU,793,2952.70,98,589.00,891,3541.70,20140401
CGG_MY57-AU,1162,3557.70,135,602.60,1297,4160.30,20140401
CGG_PNR1-AU,773,2332.60,242,726.00,1015,3058.60,20140401
CGG_PNR2-AU,122,368.20,24,72.00,146,440.20,20140401
CGG_RBX4-AU,201,525.60,20,71.00,221,596.60,20140401
CGG_RBX5-AU,240,903.40,91,364.00,331,1267.40,20140401
CGG_RBX6-AU,409,1559.55,188,745.00,597,2304.55,20140401
CGG_RBX7-AU,335,1214.95,177,697.00,512,1911.95,20140401
CGG_RS11-AU,685,975.80,36,107.40,721,1083.20,20140401
CGG_RS13-AU,492,659.85,32,91.60,524,751.45,20140401
CGG_RS14-AU,1414,1497.05,42,84.40,1456,1581.45,20140401
CGG_RS15-AU,753,1281.55,51,152.60,804,1434.15,20140401
CGG_RS16-AU,1236,1692.45,68,186.20,1304,1878.65,20140401
CGG_RS20-AU,1417,2030.45,65,173.80,1482,2204.25,20140401
CGG_RS21-AU,1435,2091.20,79,185.40,1514,2276.60,20140401
CGG_RS22-AU,2384,3255.15,97,225.60,2481,3480.75,20140401
CGG_RS23-AU,1438,2064.80,71,170.80,1509,2235.60,20140401
CGG_RS30-AU,1384,2169.10,74,192.60,1458,2361.70,20140401
CGG_RS31-AU,1568,2567.05,57,140.20,1625,2707.25,20140401
CGG_RS32-AU,938,1803.30,76,239.00,1014,2042.30,20140401
CGG_RS33-AU,1037,1856.95,46,114.40,1083,1971.35,20140401
CGG_RS41-AU,1224,2157.60,80,226.80,1304,2384.40,20140401
CGG_RS42-AU,1342,2672.75,93,277.00,1435,2949.75,20140401
CGG_RS43-AU,688,1217.45,55,145.20,743,1362.65,20140401
CGG_RS44-AU,570,1133.95,35,102.60,605,1236.55,20140401
CGG_RS45-AU,1351,2443.25,92,243.60,1443,2686.85,20140401
CGG_RS46-AU,723,1525.45,53,167.60,776,1693.05,20140401
CGG_RS50-AU,437,761.45,31,61.00,468,822.45,20140401
CGG_RS53-AU,808,1770.80,65,193.00,873,1963.80,20140401
CGG_RSX1-AU,374,531.85,17,64.00,391,595.85,20140401
CGG_RSX2-AU,596,1025.95,30,77.00,626,1102.95,20140401
CGG_RSX3-AU,394,759.40,35,123.60,429,883.00,20140401
CGG_RT12-AU,1039,2515.95,89,370.00,1128,2885.95,20140401
CGG_SS31-AU,751,1535.35,49,212.80,800,1748.15,20140401
CGG_SS32-AU,663,1275.80,49,193.80,712,1469.60,20140401
CGG_SW30-AU,333,1075.20,58,462.00,391,1537.20,20140401
CGG_SW31-AU,1073,2584.55,77,233.20,1150,2817.75,20140401
CGG_SW32-AU,334,1114.65,109,1104.00,443,2218.65,20140401
CGG_SW33-AU,619,1527.25,70,259.00,689,1786.25,20140401
CGG_SW34-AU,497,1807.35,175,1965.00,672,3772.35,20140401
CGG_SW35-AU,884,2293.15,73,249.60,957,2542.75,20140401
CGG_TM10-AU,1952,4703.10,445,1647.55,2397,6350.65,20140401
CGG_TMX3-AU,991,3163.95,285,1624.90,1276,4788.85,20140401
CGG_TMX4-AU,1635,4953.10,295,1529.40,1930,6482.50,20140401
CGG_TMX5-AU,1772,5000.60,502,2988.85,2274,7989.45,20140401
CGG_TMX6-AU,1718,5185.85,505,2970.20,2223,8156.05,20140401
CGG_TMX7-AU,1428,3585.70,312,1172.60,1740,4758.30,20140401
CGG_TMX8-AU,1924,5026.05,869,3309.90,2793,8335.95,20140401
CGG_TMX9-AU,2247,5368.25,494,1815.40,2741,7183.65,20140401
CGG_TPX1-AU,1138,2093.55,126,387.60,1264,2481.15,20140401
CGG_US10-AU,1086,1773.90,44,91.20,1130,1865.10,20140401
CGG_WES1-AU,535,2132.10,151,848.00,686,2980.10,20140401
CGG_WES2-AU,775,3029.95,138,721.90,913,3751.85,20140401
CGG_YA11-AU,763,1333.30,28,70.20,791,1403.50,20140401
CGG_YA13-AU,1769,2850.75,85,208.20,1854,3058.95,20140401
CGG_YA14-AU,1310,2144.80,65,168.40,1375,2313.20,20140401
CGG_YA15-AU,0,0.00,0,0.00,0,0.00,20140401
CGG_YA18-AU,994,1820.85,60,144.00,1054,1964.85,20140401
CGG_YA20-AU,1384,2516.25,62,158.00,1446,2674.25,20140401
CGG_YA21-AU,968,1500.20,56,140.60,1024,1640.80,20140401
CGG_YA23-AU,857,1549.05,44,116.80,901,1665.85,20140401
CGG_YA31-AU,1437,3021.00,75,239.60,1512,3260.60,20140401
CGG_YA32-AU,1022,2072.50,57,188.60,1079,2261.10,20140401
CGG_YA34-AU,836,2094.55,69,273.00,905,2367.55,20140401
CGG_YA35-AU,971,2706.95,86,401.20,1057,3108.15,20140401
CGG_YA36-AU,630,1640.40,54,220.60,684,1861.00,20140401
CGG_YAX1-AU,729,1904.15,77,312.00,806,2216.15,20140401
CGG_YAX2-AU,517,1222.55,40,144.20,557,1366.75,20140401
CGG_YAX3-AU,275,732.45,19,77.20,294,809.65,20140401
CGG_YAX4-AU,377,977.00,43,188.00,420,1165.00,20140401
CGG_YCX1-AU,282,680.80,34,147.00,316,827.80,20140401
CGG_AP21-AU,533,1109.70,74,243.20,607,1352.90,20140301
CGG_BC21-AU,255,1033.55,157,1529.15,412,2562.70,20140301
CGG_BC41-AU,269,926.40,141,650.60,410,1577.00,20140301
CGG_BC42-AU,106,405.25,65,313.60,171,718.85,20140301
CGG_BC43-AU,242,817.30,257,1260.00,499,2077.30,20140301
CGG_BR22-AU,563,1268.35,116,377.20,679,1645.55,20140301
CGG_BR23-AU,619,1590.50,172,811.80,791,2402.30,20140301
CGG_BR26-AU,741,1487.90,95,293.60,836,1781.50,20140301
CGG_BR31-AU,795,1845.15,85,322.20,880,2167.35,20140301
CGG_BR32-AU,755,1394.00,23,57.20,778,1451.20,20140301
CGG_BR33-AU,271,597.00,12,49.60,283,646.60,20140301
CGG_BR34-AU,1252,2149.15,80,208.20,1332,2357.35,20140301
CGG_BR35-AU,744,1664.30,68,277.20,812,1941.50,20140301
CGG_BR41-AU,108,405.40,110,543.60,218,949.00,20140301
CGG_BR42-AU,500,1187.55,129,471.20,629,1658.75,20140301
CGG_BR43-AU,99,387.70,86,416.20,185,803.90,20140301
CGG_BR44-AU,290,737.85,12,43.00,302,780.85,20140301
CGG_BR45-AU,98,386.65,77,366.60,175,753.25,20140301
CGG_BS11-AU,132,610.55,154,765.60,286,1376.15,20140301
CGG_BS12-AU,99,234.80,8,41.00,107,275.80,20140301
CGG_BS13-AU,117,515.10,134,661.60,251,1176.70,20140301
CGG_BS16-AU,101,439.75,74,357.00,175,796.75,20140301
CGG_BS17-AU,516,1394.30,70,589.00,586,1983.30,20140301
CGG_BS18-AU,468,1130.00,87,377.00,555,1507.00,20140301
CGG_BS21-AU,1239,2409.35,74,212.80,1313,2622.15,20140301
CGG_BS22-AU,890,1467.65,37,79.00,927,1546.65,20140301
CGG_BS23-AU,954,1904.95,66,185.60,1020,2090.55,20140301
CGG_BS24-AU,1048,1908.45,62,156.40,1110,2064.85,20140301
CGG_BS25-AU,1249,2647.90,79,239.20,1328,2887.10,20140301
CGG_BS26-AU,1653,3321.60,143,417.80,1796,3739.40,20140301
CGG_BS27-AU,1979,4495.55,108,344.40,2087,4839.95,20140301
CGG_BS29-AU,750,1890.35,52,160.00,802,2050.35,20140301
CGG_BS31-AU,612,1445.20,51,158.00,663,1603.20,20140301
CGG_BS32-AU,949,2253.25,75,247.60,1024,2500.85,20140301
CGG_BS34-AU,111,256.80,2,6.00,113,262.80,20140301
CGG_BS35-AU,596,1472.15,46,148.20,642,1620.35,20140301
CGG_BS36-AU,1706,4183.50,108,326.60,1814,4510.10,20140301
CGG_BS37-AU,1577,3894.50,104,316.40,1681,4210.90,20140301
CGG_CCX1-AU,201,1275.65,196,2318.70,397,3594.35,20140301
CGG_CCX2-AU,227,1457.30,203,2352.10,430,3809.40,20140301
CGG_CCX3-AU,60,290.95,52,480.90,112,771.85,20140301
CGG_CCX4-AU,74,416.00,57,572.10,131,988.10,20140301
CGG_CCX5-AU,224,1794.75,199,2161.30,423,3956.05,20140301
CGG_CCX6-AU,61,396.30,66,934.80,127,1331.10,20140301
CGG_CL11-AU,752,1604.15,103,319.60,855,1923.75,20140301
CGG_CLX2-AU,918,1829.80,71,223.80,989,2053.60,20140301
CGG_CPX1-AU,1808,5501.45,236,1039.80,2044,6541.25,20140301
CGG_CPX2-AU,1102,3520.25,193,861.20,1295,4381.45,20140301
CGG_CS21-AU,832,2150.60,210,957.40,1042,3108.00,20140301
CGG_CS22-AU,727,1433.35,80,246.60,807,1679.95,20140301
CGG_EB29-AU,373,1014.00,42,166.60,415,1180.60,20140301
CGG_EB31-AU,545,1359.70,48,167.60,593,1527.30,20140301
CGG_EB32-AU,670,1597.15,64,241.60,734,1838.75,20140301
CGG_EB33-AU,1370,3372.10,127,439.00,1497,3811.10,20140301
CGG_EB34-AU,889,1861.20,39,147.60,928,2008.80,20140301
CGG_EB35-AU,922,2406.40,95,368.20,1017,2774.60,20140301
CGG_EB36-AU,1036,2540.50,83,281.00,1119,2821.50,20140301
CGG_EB41-AU,694,1970.70,72,430.00,766,2400.70,20140301
CGG_EB42-AU,169,639.40,137,681.00,306,1320.40,20140301
CGG_EB44-AU,113,433.65,151,749.60,264,1183.25,20140301
CGG_EB46-AU,23,78.95,19,95.00,42,173.95,20140301
CGG_FM21-AU,395,1636.25,240,2518.70,635,4154.95,20140301
CGG_FM22-AU,331,1476.50,200,2235.35,531,3711.85,20140301
CGG_FM23-AU,230,985.25,247,2786.00,477,3771.25,20140301
CGG_FM24-AU,251,1057.50,206,2294.85,457,3352.35,20140301
CGG_FS21-AU,239,884.55,92,933.15,331,1817.70,20140301
CGG_FS22-AU,284,807.00,86,452.20,370,1259.20,20140301
CGG_FS23-AU,104,548.30,85,1081.10,189,1629.40,20140301
CGG_FS24-AU,279,847.30,54,280.00,333,1127.30,20140301
CGG_FS25-AU,297,888.75,103,496.00,400,1384.75,20140301
CGG_FS26-AU,326,981.15,92,481.60,418,1462.75,20140301
CGG_FS31-AU,788,1507.75,68,221.60,856,1729.35,20140301
CGG_FS32-AU,1068,2168.35,100,323.80,1168,2492.15,20140301
CGG_FS33-AU,1362,2437.90,119,359.20,1481,2797.10,20140301
CGG_GC13-AU,225,821.25,102,489.00,327,1310.25,20140301
CGG_GH15-AU,237,553.20,55,209.00,292,762.20,20140301
CGG_GH21-AU,479,797.65,43,119.60,522,917.25,20140301
CGG_GH23-AU,897,1496.10,88,225.80,985,1721.90,20140301
CGG_GH24-AU,1603,2696.25,120,331.80,1723,3028.05,20140301
CGG_GH31-AU,1485,2401.05,89,250.00,1574,2651.05,20140301
CGG_GH32-AU,1208,2030.60,87,250.20,1295,2280.80,20140301
CGG_GH33-AU,937,2022.15,62,226.60,999,2248.75,20140301
CGG_GH34-AU,908,1855.00,86,234.80,994,2089.80,20140301
CGG_GH36-AU,1124,2351.15,63,189.20,1187,2540.35,20140301
CGG_GHX1-AU,1070,3326.70,213,1016.60,1283,4343.30,20140301
CGG_GHX3-AU,705,2137.60,167,783.00,872,2920.60,20140301
CGG_GHX5-AU,696,2316.35,174,817.20,870,3133.55,20140301
CGG_GM11-AU,205,619.80,58,212.20,263,832.00,20140301
CGG_GM16-AU,188,533.50,41,157.00,229,690.50,20140301
CGG_HAY1-AU,403,2481.35,457,3341.30,860,5822.65,20140301
CGG_HAY2-AU,508,2931.10,553,4072.80,1061,7003.90,20140301
CGG_HAY3-AU,1374,7142.65,1201,8722.25,2575,15864.90,20140301
CGG_JSX1-AU,975,1861.00,56,160.20,1031,2021.20,20140301
CGG_JSX2-AU,1247,2230.10,104,262.80,1351,2492.90,20140301
CGG_LM11-AU,890,1668.65,88,283.60,978,1952.25,20140301
CGG_LM12-AU,895,1400.90,56,157.80,951,1558.70,20140301
CGG_LM13-AU,0,0.00,0,0.00,0,0.00,20140301
CGG_LM14-AU,486,770.05,34,111.60,520,881.65,20140301
CGG_LM15-AU,628,1172.35,57,184.20,685,1356.55,20140301
CGG_LM16-AU,779,1465.00,80,246.80,859,1711.80,20140301
CGG_LM30-AU,874,1239.00,38,88.40,912,1327.40,20140301
CGG_LM32-AU,1719,2535.70,86,189.00,1805,2724.70,20140301
CGG_LM41-AU,974,1386.60,43,93.00,1017,1479.60,20140301
CGG_LM42-AU,921,1300.35,54,134.80,975,1435.15,20140301
CGG_LM43-AU,1572,1755.10,55,112.20,1627,1867.30,20140301
CGG_LM44-AU,1538,2131.80,94,247.60,1632,2379.40,20140301
CGG_LMX2-AU,261,1415.60,157,1512.30,418,2927.90,20140301
CGG_LR11-AU,731,1338.95,51,131.80,782,1470.75,20140301
CGG_LR12-AU,1144,1995.60,59,139.60,1203,2135.20,20140301
CGG_LR13-AU,1979,3560.85,131,348.20,2110,3909.05,20140301
CGG_LR14-AU,899,1560.10,43,111.20,942,1671.30,20140301
CGG_LR15-AU,176,615.05,77,385.00,253,1000.05,20140301
CGG_LR16-AU,910,1834.75,86,257.20,996,2091.95,20140301
CGG_LR31-AU,284,617.00,28,101.00,312,718.00,20140301
CGG_LR33-AU,442,1020.20,51,209.80,493,1230.00,20140301
CGG_LR43-AU,541,1257.65,48,184.60,589,1442.25,20140301
CGG_LR47-AU,1117,2895.30,121,450.80,1238,3346.10,20140301
CGG_MB11-AU,841,1421.70,39,97.00,880,1518.70,20140301
CGG_MB12-AU,1235,2144.85,70,194.80,1305,2339.65,20140301
CGG_MB13-AU,664,1192.05,36,115.00,700,1307.05,20140301
CGG_MB14-AU,854,1307.90,30,65.60,884,1373.50,20140301
CGG_MB15-AU,510,767.90,44,114.80,554,882.70,20140301
CGG_MB16-AU,761,1208.25,43,114.00,804,1322.25,20140301
CGG_MB17-AU,1067,1583.70,80,219.20,1147,1802.90,20140301
CGG_MB23-AU,1282,2119.15,52,102.80,1334,2221.95,20140301
CGG_MB31-AU,1891,2493.50,93,235.00,1984,2728.50,20140301
CGG_MB32-AU,1577,1982.20,54,100.00,1631,2082.20,20140301
CGG_MB33-AU,1682,2396.85,66,140.00,1748,2536.85,20140301
CGG_MB34-AU,1496,1916.75,47,111.60,1543,2028.35,20140301
CGG_MB35-AU,1118,1998.30,82,257.60,1200,2255.90,20140301
CGG_MB36-AU,2203,3088.20,96,224.60,2299,3312.80,20140301
CGG_MB37-AU,1154,1748.20,89,237.80,1243,1986.00,20140301
CGG_MB38-AU,1866,2949.95,63,153.00,1929,3102.95,20140301
CGG_MB41-AU,1639,2730.00,68,182.00,1707,2912.00,20140301
CGG_MB42-AU,1137,2288.45,71,212.20,1208,2500.65,20140301
CGG_MB44-AU,1398,2878.20,83,247.00,1481,3125.20,20140301
CGG_MBX1-AU,1151,2572.10,106,329.60,1257,2901.70,20140301
CGG_MBX2-AU,984,2225.05,111,345.60,1095,2570.65,20140301
CGG_MBX4-AU,805,1754.60,39,125.00,844,1879.60,20140301
CGG_MC21-AU,774,2143.55,117,1004.05,891,3147.60,20140301
CGG_MC22-AU,491,1212.10,54,349.25,545,1561.35,20140301
CGG_MC23-AU,468,1189.85,66,547.20,534,1737.05,20140301
CGG_MK31-AU,233,692.30,27,120.00,260,812.30,20140301
CGG_MK34-AU,207,501.65,35,133.20,242,634.85,20140301
CGG_MK35-AU,157,395.20,45,202.00,202,597.20,20140301
CGG_MM41-AU,1637,2382.65,122,284.60,1759,2667.25,20140301
CGG_MS10-AU,486,692.35,22,58.60,508,750.95,20140301
CGG_MS11-AU,1123,1828.10,80,213.00,1203,2041.10,20140301
CGG_MS12-AU,1565,2207.50,93,230.00,1658,2437.50,20140301
CGG_MS21-AU,1357,2106.95,101,235.20,1458,2342.15,20140301
CGG_MS30-AU,543,792.55,34,80.00,577,872.55,20140301
CGG_MS31-AU,2119,3415.55,84,196.60,2203,3612.15,20140301
CGG_MS32-AU,1040,1604.20,83,214.60,1123,1818.80,20140301
CGG_MS41-AU,880,1290.05,43,94.80,923,1384.85,20140301
CGG_MS42-AU,1675,2009.30,77,132.40,1752,2141.70,20140301
CGG_MS43-AU,1732,2481.45,111,248.60,1843,2730.05,20140301
CGG_MS44-AU,1306,1702.10,72,164.80,1378,1866.90,20140301
CGG_MS46-AU,1220,1543.95,52,102.60,1272,1646.55,20140301
CGG_MY21-AU,892,1636.40,46,129.40,938,1765.80,20140301
CGG_MY22-AU,158,299.95,10,31.00,168,330.95,20140301
CGG_MY23-AU,682,1306.45,40,107.40,722,1413.85,20140301
CGG_MY24-AU,0,0.00,0,0.00,0,0.00,20140301
CGG_MY25-AU,1048,1999.10,49,154.00,1097,2153.10,20140301
CGG_MY31-AU,549,1181.30,80,281.20,629,1462.50,20140301
CGG_MY32-AU,797,1767.15,65,219.20,862,1986.35,20140301
CGG_MY33-AU,374,885.65,53,174.80,427,1060.45,20140301
CGG_MY34-AU,531,1329.10,27,92.00,558,1421.10,20140301
CGG_MY35-AU,369,810.75,41,125.20,410,935.95,20140301
CGG_MY41-AU,1831,3568.05,99,275.60,1930,3843.65,20140301
CGG_MY42-AU,2248,4031.70,101,268.60,2349,4300.30,20140301
CGG_MY43-AU,961,2374.80,54,172.40,1015,2547.20,20140301
CGG_MY44-AU,457,1161.35,33,119.00,490,1280.35,20140301
CGG_MY45-AU,850,2209.85,49,157.00,899,2366.85,20140301
CGG_MY46-AU,1675,4481.75,123,402.60,1798,4884.35,20140301
CGG_MY47-AU,1156,3034.30,77,262.60,1233,3296.90,20140301
CGG_MY51-AU,964,2786.40,121,542.60,1085,3329.00,20140301
CGG_MY52-AU,894,3000.20,179,1100.00,1073,4100.20,20140301
CGG_MY53-AU,586,1690.50,69,301.60,655,1992.10,20140301
CGG_MY54-AU,824,2870.60,171,1046.80,995,3917.40,20140301
CGG_MY55-AU,1057,3162.50,120,541.80,1177,3704.30,20140301
CGG_MY56-AU,1065,3883.95,171,1018.80,1236,4902.75,20140301
CGG_MY57-AU,1024,3121.25,148,678.60,1172,3799.85,20140301
CGG_PNR1-AU,784,2365.50,235,705.00,1019,3070.50,20140301
CGG_PNR2-AU,126,379.35,26,78.00,152,457.35,20140301
CGG_RBX4-AU,141,353.45,16,53.00,157,406.45,20140301
CGG_RBX5-AU,242,931.20,104,415.00,346,1346.20,20140301
CGG_RBX6-AU,423,1593.20,221,878.00,644,2471.20,20140301
CGG_RBX7-AU,351,1256.20,125,494.00,476,1750.20,20140301
CGG_RS11-AU,672,912.75,40,114.80,712,1027.55,20140301
CGG_RS13-AU,542,759.20,29,84.80,571,844.00,20140301
CGG_RS14-AU,1340,1380.90,38,88.20,1378,1469.10,20140301
CGG_RS15-AU,751,1289.85,78,217.20,829,1507.05,20140301
CGG_RS16-AU,1288,1583.05,75,186.20,1363,1769.25,20140301
CGG_RS20-AU,1245,1799.00,69,164.20,1314,1963.20,20140301
CGG_RS21-AU,1342,1908.40,79,154.80,1421,2063.20,20140301
CGG_RS22-AU,2114,2851.00,93,193.20,2207,3044.20,20140301
CGG_RS23-AU,1469,2048.55,87,205.40,1556,2253.95,20140301
CGG_RS30-AU,1210,1791.65,85,230.40,1295,2022.05,20140301
CGG_RS31-AU,1417,2219.50,94,227.00,1511,2446.50,20140301
CGG_RS32-AU,1010,1788.05,58,145.20,1068,1933.25,20140301
CGG_RS33-AU,1028,1673.00,49,134.80,1077,1807.80,20140301
CGG_RS41-AU,1137,1918.50,89,235.80,1226,2154.30,20140301
CGG_RS42-AU,1257,2465.25,101,300.60,1358,2765.85,20140301
CGG_RS43-AU,647,1137.60,58,151.80,705,1289.40,20140301
CGG_RS44-AU,527,1040.60,40,101.80,567,1142.40,20140301
CGG_RS45-AU,1309,2392.10,109,314.60,1418,2706.70,20140301
CGG_RS46-AU,764,1627.70,49,143.20,813,1770.90,20140301
CGG_RS50-AU,437,762.50,29,54.60,466,817.10,20140301
CGG_RS53-AU,764,1690.75,61,180.20,825,1870.95,20140301
CGG_RSX1-AU,335,471.15,13,36.80,348,507.95,20140301
CGG_RSX2-AU,619,1093.90,34,88.80,653,1182.70,20140301
CGG_RSX3-AU,433,863.65,52,193.00,485,1056.65,20140301
CGG_RT12-AU,1092,2704.10,112,495.40,1204,3199.50,20140301
CGG_SS31-AU,698,1467.90,38,167.60,736,1635.50,20140301
CGG_SS32-AU,604,1214.35,43,185.60,647,1399.95,20140301
CGG_SW30-AU,284,834.25,64,566.00,348,1400.25,20140301
CGG_SW31-AU,1073,2522.25,121,418.20,1194,2940.45,20140301
CGG_SW32-AU,328,1126.90,96,1043.00,424,2169.90,20140301
CGG_SW33-AU,611,1493.25,65,228.60,676,1721.85,20140301
CGG_SW34-AU,495,1729.05,151,1537.00,646,3266.05,20140301
CGG_SW35-AU,803,2104.05,88,296.80,891,2400.85,20140301
CGG_TM10-AU,1925,4606.75,357,1296.85,2282,5903.60,20140301
CGG_TMX3-AU,905,2744.85,251,1459.10,1156,4203.95,20140301
CGG_TMX4-AU,1435,4326.90,336,1809.30,1771,6136.20,20140301
CGG_TMX5-AU,1646,4876.65,560,3380.05,2206,8256.70,20140301
CGG_TMX6-AU,1550,4751.20,615,3582.00,2165,8333.20,20140301
CGG_TMX7-AU,1264,3220.65,353,1349.30,1617,4569.95,20140301
CGG_TMX8-AU,2091,5587.75,970,3703.30,3061,9291.05,20140301
CGG_TMX9-AU,2078,5012.60,372,1348.75,2450,6361.35,20140301
CGG_TPX1-AU,1072,1876.95,178,547.10,1250,2424.05,20140301
CGG_US10-AU,971,1570.25,59,135.20,1030,1705.45,20140301
CGG_WES1-AU,427,1630.10,70,398.65,497,2028.75,20140301
CGG_WES2-AU,456,1607.45,112,590.20,568,2197.65,20140301
CGG_YA11-AU,707,1213.40,19,44.60,726,1258.00,20140301
CGG_YA13-AU,1565,2428.80,80,200.40,1645,2629.20,20140301
CGG_YA14-AU,1334,2149.15,53,119.00,1387,2268.15,20140301
CGG_YA15-AU,0,0.00,0,0.00,0,0.00,20140301
CGG_YA18-AU,869,1510.60,58,150.80,927,1661.40,20140301
CGG_YA20-AU,1438,2429.20,78,189.40,1516,2618.60,20140301
CGG_YA21-AU,958,1549.40,42,93.80,1000,1643.20,20140301
CGG_YA23-AU,814,1401.50,44,95.20,858,1496.70,20140301
CGG_YA31-AU,1343,2776.75,78,238.20,1421,3014.95,20140301
CGG_YA32-AU,918,1772.25,48,128.20,966,1900.45,20140301
CGG_YA34-AU,734,1672.60,59,217.60,793,1890.20,20140301
CGG_YA35-AU,862,2285.75,99,462.60,961,2748.35,20140301
CGG_YA36-AU,497,1272.40,40,173.00,537,1445.40,20140301
CGG_YAX1-AU,653,1624.85,81,311.20,734,1936.05,20140301
CGG_YAX2-AU,527,1349.30,50,198.00,577,1547.30,20140301
CGG_YAX3-AU,257,696.20,26,117.00,283,813.20,20140301
CGG_YAX4-AU,301,745.25,37,185.00,338,930.25,20140301
CGG_YCX1-AU,348,824.10,25,90.00,373,914.10,20140301
CGG_AP21-AU,505,1084.65,50,171.60,555,1256.25,20140201
CGG_BC21-AU,224,819.45,157,1698.85,381,2518.30,20140201
CGG_BC41-AU,300,1009.20,119,580.60,419,1589.80,20140201
CGG_BC42-AU,112,403.05,86,430.00,198,833.05,20140201
CGG_BC43-AU,239,844.80,226,1103.60,465,1948.40,20140201
CGG_BR22-AU,453,876.30,72,228.00,525,1104.30,20140201
CGG_BR23-AU,667,1639.85,138,647.20,805,2287.05,20140201
CGG_BR26-AU,707,1409.60,67,206.00,774,1615.60,20140201
CGG_BR31-AU,793,1733.55,55,222.60,848,1956.15,20140201
CGG_BR32-AU,650,1213.55,18,50.20,668,1263.75,20140201
CGG_BR33-AU,223,444.00,28,119.00,251,563.00,20140201
CGG_BR34-AU,1247,2197.20,73,173.80,1320,2371.00,20140201
CGG_BR35-AU,734,1660.70,45,185.20,779,1845.90,20140201
CGG_BR41-AU,124,459.65,118,585.00,242,1044.65,20140201
CGG_BR42-AU,545,1273.60,108,385.80,653,1659.40,20140201
CGG_BR43-AU,89,355.25,60,295.60,149,650.85,20140201
CGG_BR44-AU,276,746.00,14,49.00,290,795.00,20140201
CGG_BR45-AU,93,378.05,89,440.60,182,818.65,20140201
CGG_BS11-AU,138,617.70,170,850.00,308,1467.70,20140201
CGG_BS12-AU,0,0.00,0,0.00,0,0.00,20140201
CGG_BS13-AU,100,460.00,140,700.00,240,1160.00,20140201
CGG_BS16-AU,140,558.85,68,332.00,208,890.85,20140201
CGG_BS17-AU,545,1430.90,73,616.00,618,2046.90,20140201
CGG_BS18-AU,449,1024.75,82,374.00,531,1398.75,20140201
CGG_BS21-AU,1333,2703.20,73,203.40,1406,2906.60,20140201
CGG_BS22-AU,865,1493.20,32,91.20,897,1584.40,20140201
CGG_BS23-AU,905,1780.35,72,220.60,977,2000.95,20140201
CGG_BS24-AU,1055,1882.60,58,160.60,1113,2043.20,20140201
CGG_BS25-AU,1249,2606.05,71,203.40,1320,2809.45,20140201
CGG_BS26-AU,1667,3434.35,115,317.40,1782,3751.75,20140201
CGG_BS27-AU,1924,4379.35,130,400.60,2054,4779.95,20140201
CGG_BS29-AU,774,1972.40,52,184.60,826,2157.00,20140201
CGG_BS31-AU,636,1603.95,33,102.60,669,1706.55,20140201
CGG_BS32-AU,993,2316.40,52,170.60,1045,2487.00,20140201
CGG_BS34-AU,125,311.95,6,24.00,131,335.95,20140201
CGG_BS35-AU,629,1578.35,32,107.60,661,1685.95,20140201
CGG_BS36-AU,1663,4118.60,128,427.80,1791,4546.40,20140201
CGG_BS37-AU,1515,3755.95,98,312.20,1613,4068.15,20140201
CGG_CCX1-AU,189,1025.95,208,2485.80,397,3511.75,20140201
CGG_CCX2-AU,237,1277.85,167,1874.40,404,3152.25,20140201
CGG_CCX3-AU,49,274.60,31,319.40,80,594.00,20140201
CGG_CCX4-AU,57,285.50,31,287.10,88,572.60,20140201
CGG_CCX5-AU,278,1855.80,221,2517.40,499,4373.20,20140201
CGG_CCX6-AU,50,343.95,75,921.60,125,1265.55,20140201
CGG_CL11-AU,684,1370.00,81,214.60,765,1584.60,20140201
CGG_CLX2-AU,828,1642.70,82,250.40,910,1893.10,20140201
CGG_CPX1-AU,1425,3766.50,198,826.60,1623,4593.10,20140201
CGG_CPX2-AU,957,2422.50,84,294.60,1041,2717.10,20140201
CGG_CS21-AU,748,2077.55,141,634.20,889,2711.75,20140201
CGG_CS22-AU,628,1227.25,53,155.20,681,1382.45,20140201
CGG_EB29-AU,411,1076.20,30,123.00,441,1199.20,20140201
CGG_EB31-AU,587,1480.95,44,145.00,631,1625.95,20140201
CGG_EB32-AU,652,1566.35,77,278.00,729,1844.35,20140201
CGG_EB33-AU,1339,3091.30,132,496.40,1471,3587.70,20140201
CGG_EB34-AU,873,1825.05,44,138.60,917,1963.65,20140201
CGG_EB35-AU,945,2417.50,84,306.40,1029,2723.90,20140201
CGG_EB36-AU,1037,2515.50,90,315.20,1127,2830.70,20140201
CGG_EB41-AU,723,2074.70,79,424.00,802,2498.70,20140201
CGG_EB42-AU,207,793.00,157,777.00,364,1570.00,20140201
CGG_EB44-AU,132,451.15,143,712.00,275,1163.15,20140201
CGG_EB46-AU,0,0.00,0,0.00,0,0.00,20140201
CGG_FM21-AU,473,1691.30,189,1860.00,662,3551.30,20140201
CGG_FM22-AU,409,1572.15,204,2271.70,613,3843.85,20140201
CGG_FM23-AU,312,1197.05,233,2598.85,545,3795.90,20140201
CGG_FM24-AU,264,1055.95,225,2585.20,489,3641.15,20140201
CGG_FS21-AU,217,796.05,88,970.90,305,1766.95,20140201
CGG_FS22-AU,336,969.70,73,352.00,409,1321.70,20140201
CGG_FS23-AU,137,543.05,102,1261.25,239,1804.30,20140201
CGG_FS24-AU,387,1062.40,76,382.00,463,1444.40,20140201
CGG_FS25-AU,321,930.25,89,434.20,410,1364.45,20140201
CGG_FS26-AU,342,1034.15,75,347.60,417,1381.75,20140201
CGG_FS31-AU,911,1719.65,46,144.60,957,1864.25,20140201
CGG_FS32-AU,1147,2281.15,95,296.00,1242,2577.15,20140201
CGG_FS33-AU,1528,2722.70,100,286.80,1628,3009.50,20140201
CGG_GC13-AU,182,631.95,129,623.00,311,1254.95,20140201
CGG_GH15-AU,216,495.85,44,160.60,260,656.45,20140201
CGG_GH21-AU,452,799.35,38,104.40,490,903.75,20140201
CGG_GH23-AU,975,1651.25,63,155.80,1038,1807.05,20140201
CGG_GH24-AU,1623,2653.30,144,399.40,1767,3052.70,20140201
CGG_GH31-AU,1582,2458.45,125,363.00,1707,2821.45,20140201
CGG_GH32-AU,1454,2459.05,97,281.00,1551,2740.05,20140201
CGG_GH33-AU,951,2096.15,72,295.80,1023,2391.95,20140201
CGG_GH34-AU,1025,2134.45,89,258.60,1114,2393.05,20140201
CGG_GH36-AU,1276,2605.15,72,200.00,1348,2805.15,20140201
CGG_GHX1-AU,887,2298.20,162,744.00,1049,3042.20,20140201
CGG_GHX3-AU,533,1200.70,104,478.00,637,1678.70,20140201
CGG_GHX5-AU,400,1168.80,68,308.20,468,1477.00,20140201
CGG_GM11-AU,148,422.50,35,134.00,183,556.50,20140201
CGG_GM16-AU,204,485.85,34,125.60,238,611.45,20140201
CGG_HAY1-AU,371,2343.85,515,3797.55,886,6141.40,20140201
CGG_HAY2-AU,431,2642.40,579,4274.90,1010,6917.30,20140201
CGG_HAY3-AU,1458,7546.65,1183,8607.30,2641,16153.95,20140201
CGG_JSX1-AU,1028,1933.90,75,190.40,1103,2124.30,20140201
CGG_JSX2-AU,1201,2096.35,105,288.40,1306,2384.75,20140201
CGG_LM11-AU,939,1798.05,92,301.40,1031,2099.45,20140201
CGG_LM12-AU,969,1652.30,74,240.20,1043,1892.50,20140201
CGG_LM13-AU,577,949.25,37,110.20,614,1059.45,20140201
CGG_LM14-AU,542,813.50,36,104.40,578,917.90,20140201
CGG_LM15-AU,591,1161.20,47,148.60,638,1309.80,20140201
CGG_LM16-AU,771,1504.35,55,171.20,826,1675.55,20140201
CGG_LM30-AU,894,1284.10,44,92.40,938,1376.50,20140201
CGG_LM32-AU,1754,2521.50,80,173.60,1834,2695.10,20140201
CGG_LM41-AU,961,1453.45,43,96.00,1004,1549.45,20140201
CGG_LM42-AU,925,1318.10,53,104.60,978,1422.70,20140201
CGG_LM43-AU,1451,1714.75,57,112.60,1508,1827.35,20140201
CGG_LM44-AU,1587,2279.85,71,167.40,1658,2447.25,20140201
CGG_LMX2-AU,334,1681.65,142,1472.15,476,3153.80,20140201
CGG_LR11-AU,789,1369.00,65,172.00,854,1541.00,20140201
CGG_LR12-AU,1192,2063.90,94,267.60,1286,2331.50,20140201
CGG_LR13-AU,2219,3757.40,120,315.20,2339,4072.60,20140201
CGG_LR14-AU,867,1552.80,53,153.20,920,1706.00,20140201
CGG_LR15-AU,200,682.75,81,383.00,281,1065.75,20140201
CGG_LR16-AU,920,1877.55,115,329.40,1035,2206.95,20140201
CGG_LR31-AU,362,873.65,32,119.20,394,992.85,20140201
CGG_LR33-AU,508,1153.10,45,188.20,553,1341.30,20140201
CGG_LR43-AU,734,1804.95,61,225.00,795,2029.95,20140201
CGG_LR47-AU,1151,2921.50,101,397.00,1252,3318.50,20140201
CGG_MB11-AU,727,1317.30,36,89.00,763,1406.30,20140201
CGG_MB12-AU,1165,2088.40,86,213.00,1251,2301.40,20140201
CGG_MB13-AU,714,1239.95,33,89.00,747,1328.95,20140201
CGG_MB14-AU,817,1256.90,38,88.40,855,1345.30,20140201
CGG_MB15-AU,527,781.25,39,104.20,566,885.45,20140201
CGG_MB16-AU,736,1151.55,43,116.20,779,1267.75,20140201
CGG_MB17-AU,1116,1584.25,87,243.20,1203,1827.45,20140201
CGG_MB23-AU,1299,2003.85,41,101.20,1340,2105.05,20140201
CGG_MB31-AU,1940,2604.45,66,135.00,2006,2739.45,20140201
CGG_MB32-AU,1701,2039.80,52,105.00,1753,2144.80,20140201
CGG_MB33-AU,1725,2301.05,66,156.00,1791,2457.05,20140201
CGG_MB34-AU,1636,1959.10,43,79.60,1679,2038.70,20140201
CGG_MB35-AU,1151,1980.95,87,273.80,1238,2254.75,20140201
CGG_MB36-AU,2258,3021.35,109,258.00,2367,3279.35,20140201
CGG_MB37-AU,1119,1754.00,76,203.60,1195,1957.60,20140201
CGG_MB38-AU,1983,3023.40,68,168.20,2051,3191.60,20140201
CGG_MB41-AU,1626,2701.05,73,182.80,1699,2883.85,20140201
CGG_MB42-AU,625,1267.35,30,92.00,655,1359.35,20140201
CGG_MB44-AU,1439,3004.65,66,201.60,1505,3206.25,20140201
CGG_MBX1-AU,1067,2378.10,74,234.60,1141,2612.70,20140201
CGG_MBX2-AU,960,2106.70,96,274.40,1056,2381.10,20140201
CGG_MBX4-AU,771,1594.05,49,154.60,820,1748.65,20140201
CGG_MC21-AU,871,2060.90,94,683.55,965,2744.45,20140201
CGG_MC22-AU,666,1635.50,54,347.70,720,1983.20,20140201
CGG_MC23-AU,676,1655.85,83,666.55,759,2322.40,20140201
CGG_MK31-AU,216,620.55,44,225.20,260,845.75,20140201
CGG_MK34-AU,216,564.95,32,123.00,248,687.95,20140201
CGG_MK35-AU,176,401.35,23,114.00,199,515.35,20140201
CGG_MM41-AU,1707,2505.70,92,206.40,1799,2712.10,20140201
CGG_MS10-AU,485,701.45,29,76.00,514,777.45,20140201
CGG_MS11-AU,1041,1746.05,63,165.00,1104,1911.05,20140201
CGG_MS12-AU,1555,2173.80,65,146.20,1620,2320.00,20140201
CGG_MS21-AU,1425,2170.80,83,199.80,1508,2370.60,20140201
CGG_MS30-AU,636,910.95,34,72.20,670,983.15,20140201
CGG_MS31-AU,2089,3419.90,118,245.40,2207,3665.30,20140201
CGG_MS32-AU,1107,1710.35,90,255.80,1197,1966.15,20140201
CGG_MS41-AU,963,1445.85,47,90.80,1010,1536.65,20140201
CGG_MS42-AU,1697,1921.50,75,120.00,1772,2041.50,20140201
CGG_MS43-AU,1695,2373.10,91,224.60,1786,2597.70,20140201
CGG_MS44-AU,1427,1792.60,52,98.60,1479,1891.20,20140201
CGG_MS46-AU,1191,1539.35,42,87.00,1233,1626.35,20140201
CGG_MY21-AU,849,1533.40,40,95.00,889,1628.40,20140201
CGG_MY22-AU,199,436.40,11,28.20,210,464.60,20140201
CGG_MY23-AU,780,1457.95,33,96.60,813,1554.55,20140201
CGG_MY24-AU,0,0.00,0,0.00,0,0.00,20140201
CGG_MY25-AU,1115,2148.30,54,148.20,1169,2296.50,20140201
CGG_MY31-AU,596,1278.40,85,291.60,681,1570.00,20140201
CGG_MY32-AU,765,1670.65,77,245.80,842,1916.45,20140201
CGG_MY33-AU,385,908.40,54,182.20,439,1090.60,20140201
CGG_MY34-AU,493,1275.15,35,117.00,528,1392.15,20140201
CGG_MY35-AU,334,811.65,42,146.00,376,957.65,20140201
CGG_MY41-AU,1664,3186.25,84,234.80,1748,3421.05,20140201
CGG_MY42-AU,2132,3688.20,116,285.40,2248,3973.60,20140201
CGG_MY43-AU,956,2369.40,57,175.00,1013,2544.40,20140201
CGG_MY44-AU,481,1234.45,31,96.20,512,1330.65,20140201
CGG_MY45-AU,827,2241.70,57,188.00,884,2429.70,20140201
CGG_MY46-AU,1696,4453.20,107,357.20,1803,4810.40,20140201
CGG_MY47-AU,1220,3220.55,91,283.60,1311,3504.15,20140201
CGG_MY51-AU,956,2838.25,106,466.20,1062,3304.45,20140201
CGG_MY52-AU,868,2934.10,207,1231.80,1075,4165.90,20140201
CGG_MY53-AU,629,1877.00,76,331.60,705,2208.60,20140201
CGG_MY54-AU,923,3179.35,125,717.20,1048,3896.55,20140201
CGG_MY55-AU,1028,3030.05,120,539.00,1148,3569.05,20140201
CGG_MY56-AU,1066,3957.65,197,1175.00,1263,5132.65,20140201
CGG_MY57-AU,1057,3258.10,131,565.60,1188,3823.70,20140201
CGG_PNR1-AU,862,2596.25,281,843.00,1143,3439.25,20140201
CGG_PNR2-AU,96,288.00,18,54.00,114,342.00,20140201
CGG_RBX4-AU,231,625.00,31,100.00,262,725.00,20140201
CGG_RBX5-AU,264,982.50,85,340.00,349,1322.50,20140201
CGG_RBX6-AU,397,1506.10,214,848.00,611,2354.10,20140201
CGG_RBX7-AU,378,1325.35,147,581.00,525,1906.35,20140201
CGG_RS11-AU,832,1082.90,37,90.00,869,1172.90,20140201
CGG_RS13-AU,547,809.40,52,129.60,599,939.00,20140201
CGG_RS14-AU,1384,1444.85,45,94.20,1429,1539.05,20140201
CGG_RS15-AU,724,1235.85,81,218.00,805,1453.85,20140201
CGG_RS16-AU,1341,1744.30,61,149.60,1402,1893.90,20140201
CGG_RS20-AU,1238,1855.70,64,148.00,1302,2003.70,20140201
CGG_RS21-AU,1457,2164.80,76,186.80,1533,2351.60,20140201
CGG_RS22-AU,2173,2934.90,120,298.20,2293,3233.10,20140201
CGG_RS23-AU,1453,2065.65,75,157.20,1528,2222.85,20140201
CGG_RS30-AU,1285,1892.50,63,130.20,1348,2022.70,20140201
CGG_RS31-AU,1411,2250.60,62,149.00,1473,2399.60,20140201
CGG_RS32-AU,1027,1756.55,60,183.60,1087,1940.15,20140201
CGG_RS33-AU,1014,1745.00,42,101.80,1056,1846.80,20140201
CGG_RS41-AU,1166,2060.45,79,228.40,1245,2288.85,20140201
CGG_RS42-AU,1318,2552.55,84,226.00,1402,2778.55,20140201
CGG_RS43-AU,625,1099.35,39,103.20,664,1202.55,20140201
CGG_RS44-AU,477,944.65,31,89.60,508,1034.25,20140201
CGG_RS45-AU,1274,2311.40,101,267.00,1375,2578.40,20140201
CGG_RS46-AU,804,1701.30,65,187.80,869,1889.10,20140201
CGG_RS50-AU,400,685.45,19,35.20,419,720.65,20140201
CGG_RS53-AU,795,1710.35,73,223.80,868,1934.15,20140201
CGG_RSX1-AU,341,474.10,9,29.60,350,503.70,20140201
CGG_RSX2-AU,590,1067.20,35,104.20,625,1171.40,20140201
CGG_RSX3-AU,414,862.35,29,93.20,443,955.55,20140201
CGG_RT12-AU,997,2327.55,123,538.00,1120,2865.55,20140201
CGG_SS31-AU,834,1525.30,51,206.40,885,1731.70,20140201
CGG_SS32-AU,633,1156.10,20,76.00,653,1232.10,20140201
CGG_SW30-AU,323,961.30,61,435.00,384,1396.30,20140201
CGG_SW31-AU,1112,2622.90,84,277.20,1196,2900.10,20140201
CGG_SW32-AU,355,1085.15,100,978.00,455,2063.15,20140201
CGG_SW33-AU,599,1495.70,73,234.60,672,1730.30,20140201
CGG_SW34-AU,647,2312.40,134,1305.00,781,3617.40,20140201
CGG_SW35-AU,806,2066.15,71,231.00,877,2297.15,20140201
CGG_TM10-AU,1984,4762.25,279,997.20,2263,5759.45,20140201
CGG_TMX3-AU,965,2990.60,232,1349.50,1197,4340.10,20140201
CGG_TMX4-AU,1438,4529.25,293,1602.45,1731,6131.70,20140201
CGG_TMX5-AU,1596,4541.85,480,2825.35,2076,7367.20,20140201
CGG_TMX6-AU,1477,4471.95,475,2723.90,1952,7195.85,20140201
CGG_TMX7-AU,1407,3446.10,333,1251.40,1740,4697.50,20140201
CGG_TMX8-AU,2299,5894.40,816,3109.10,3115,9003.50,20140201
CGG_TMX9-AU,2260,5270.50,445,1615.70,2705,6886.20,20140201
CGG_TPX1-AU,1019,1824.10,173,523.95,1192,2348.05,20140201
CGG_US10-AU,973,1503.40,72,202.00,1045,1705.40,20140201
CGG_WES1-AU,358,1449.40,86,499.35,444,1948.75,20140201
CGG_WES2-AU,576,2253.35,112,608.25,688,2861.60,20140201
CGG_YA11-AU,620,1016.40,29,84.00,649,1100.40,20140201
CGG_YA13-AU,1573,2484.90,76,179.00,1649,2663.90,20140201
CGG_YA14-AU,1320,2086.20,53,101.20,1373,2187.40,20140201
CGG_YA15-AU,0,0.00,0,0.00,0,0.00,20140201
CGG_YA18-AU,918,1620.35,52,119.80,970,1740.15,20140201
CGG_YA20-AU,1386,2457.00,55,146.60,1441,2603.60,20140201
CGG_YA21-AU,954,1451.05,45,114.60,999,1565.65,20140201
CGG_YA23-AU,781,1383.75,43,118.60,824,1502.35,20140201
CGG_YA31-AU,1337,2823.20,95,254.40,1432,3077.60,20140201
CGG_YA32-AU,938,1773.50,42,122.60,980,1896.10,20140201
CGG_YA34-AU,747,1787.10,39,177.60,786,1964.70,20140201
CGG_YA35-AU,838,2159.80,69,267.60,907,2427.40,20140201
CGG_YA36-AU,492,1313.05,53,210.60,545,1523.65,20140201
CGG_YAX1-AU,711,1792.65,73,303.00,784,2095.65,20140201
CGG_YAX2-AU,577,1402.20,65,258.20,642,1660.40,20140201
CGG_YAX3-AU,235,605.95,37,147.60,272,753.55,20140201
CGG_YAX4-AU,305,707.50,27,111.00,332,818.50,20140201
CGG_YCX1-AU,327,690.30,15,48.00,342,738.30,20140201
CGG_AP21-AU,207,435.85,40,140.00,247,575.85,20140101
CGG_BC21-AU,231,878.55,136,1568.10,367,2446.65,20140101
CGG_BC41-AU,311,1094.95,151,728.00,462,1822.95,20140101
CGG_BC42-AU,158,635.20,57,280.00,215,915.20,20140101
CGG_BC43-AU,321,1217.30,231,1133.00,552,2350.30,20140101
CGG_BR22-AU,438,929.95,37,119.00,475,1048.95,20140101
CGG_BR23-AU,765,1889.00,81,354.60,846,2243.60,20140101
CGG_BR26-AU,739,1581.50,74,233.60,813,1815.10,20140101
CGG_BR31-AU,819,1976.65,28,116.00,847,2092.65,20140101
CGG_BR32-AU,746,1494.90,20,56.00,766,1550.90,20140101
CGG_BR33-AU,317,658.00,24,94.60,341,752.60,20140101
CGG_BR34-AU,1271,2344.65,46,113.80,1317,2458.45,20140101
CGG_BR35-AU,878,2096.10,46,168.80,924,2264.90,20140101
CGG_BR41-AU,188,675.25,65,316.00,253,991.25,20140101
CGG_BR42-AU,638,1566.10,85,317.00,723,1883.10,20140101
CGG_BR43-AU,116,452.80,76,376.00,192,828.80,20140101
CGG_BR44-AU,300,798.00,3,11.00,303,809.00,20140101
CGG_BR45-AU,127,515.20,72,357.00,199,872.20,20140101
CGG_BS11-AU,205,881.90,161,817.00,366,1698.90,20140101
CGG_BS12-AU,0,0.00,0,0.00,0,0.00,20140101
CGG_BS13-AU,138,580.60,142,703.60,280,1284.20,20140101
CGG_BS16-AU,147,592.45,58,284.00,205,876.45,20140101
CGG_BS17-AU,605,1702.15,70,444.00,675,2146.15,20140101
CGG_BS18-AU,412,1036.10,83,376.00,495,1412.10,20140101
CGG_BS21-AU,1336,2530.00,49,145.20,1385,2675.20,20140101
CGG_BS22-AU,1001,1716.65,30,67.00,1031,1783.65,20140101
CGG_BS23-AU,911,1759.95,43,112.40,954,1872.35,20140101
CGG_BS24-AU,1113,1970.35,43,111.60,1156,2081.95,20140101
CGG_BS25-AU,1172,2490.75,69,204.80,1241,2695.55,20140101
CGG_BS26-AU,1729,3517.50,106,274.20,1835,3791.70,20140101
CGG_BS27-AU,1862,4176.65,107,350.20,1969,4526.85,20140101
CGG_BS29-AU,847,2107.00,52,165.20,899,2272.20,20140101
CGG_BS31-AU,694,1698.05,38,127.00,732,1825.05,20140101
CGG_BS32-AU,1005,2424.55,59,178.00,1064,2602.55,20140101
CGG_BS34-AU,135,319.60,8,27.00,143,346.60,20140101
CGG_BS35-AU,710,1724.10,44,145.60,754,1869.70,20140101
CGG_BS36-AU,1838,4583.00,102,315.40,1940,4898.40,20140101
CGG_BS37-AU,1677,4132.25,76,249.00,1753,4381.25,20140101
CGG_CCX1-AU,199,1010.60,126,1484.90,325,2495.50,20140101
CGG_CCX2-AU,169,836.80,83,909.60,252,1746.40,20140101
CGG_CCX3-AU,23,95.25,15,184.30,38,279.55,20140101
CGG_CCX4-AU,12,71.90,12,136.80,24,208.70,20140101
CGG_CCX5-AU,154,1099.80,138,1653.40,292,2753.20,20140101
CGG_CCX6-AU,52,365.50,45,579.70,97,945.20,20140101
CGG_CL11-AU,638,1306.80,61,191.00,699,1497.80,20140101
CGG_CLX2-AU,807,1552.15,50,144.20,857,1696.35,20140101
CGG_CPX1-AU,1966,5495.85,157,604.20,2123,6100.05,20140101
CGG_CPX2-AU,1129,2978.25,100,377.00,1229,3355.25,20140101
CGG_CS21-AU,729,1771.75,131,580.00,860,2351.75,20140101
CGG_CS22-AU,558,1133.75,45,140.00,603,1273.75,20140101
CGG_EB29-AU,485,1284.35,28,101.00,513,1385.35,20140101
CGG_EB31-AU,633,1640.00,45,164.00,678,1804.00,20140101
CGG_EB32-AU,788,1901.10,55,235.40,843,2136.50,20140101
CGG_EB33-AU,1372,3513.90,94,357.60,1466,3871.50,20140101
CGG_EB34-AU,907,2030.43,39,142.20,946,2172.63,20140101
CGG_EB35-AU,1210,3354.00,101,407.00,1311,3761.00,20140101
CGG_EB36-AU,1234,3207.30,75,303.20,1309,3510.50,20140101
CGG_EB41-AU,719,2205.80,76,595.00,795,2800.80,20140101
CGG_EB42-AU,225,866.75,106,527.00,331,1393.75,20140101
CGG_EB44-AU,186,631.90,105,505.60,291,1137.50,20140101
CGG_EB46-AU,0,0.00,0,0.00,0,0.00,20140101
CGG_FM21-AU,381,1093.70,94,981.95,475,2075.65,20140101
CGG_FM22-AU,231,813.85,105,1152.35,336,1966.20,20140101
CGG_FM23-AU,203,850.50,217,2513.35,420,3363.85,20140101
CGG_FM24-AU,204,703.75,170,1983.25,374,2687.00,20140101
CGG_FS21-AU,222,614.25,46,464.55,268,1078.80,20140101
CGG_FS22-AU,221,539.15,20,57.00,241,596.15,20140101
CGG_FS23-AU,110,346.95,88,1124.80,198,1471.75,20140101
CGG_FS24-AU,203,354.85,22,82.60,225,437.45,20140101
CGG_FS25-AU,223,622.95,31,147.00,254,769.95,20140101
CGG_FS26-AU,204,529.15,21,93.60,225,622.75,20140101
CGG_FS31-AU,709,1324.45,43,131.20,752,1455.65,20140101
CGG_FS32-AU,795,1545.90,51,158.20,846,1704.10,20140101
CGG_FS33-AU,1234,2193.55,82,214.60,1316,2408.15,20140101
CGG_GC13-AU,157,624.90,121,596.00,278,1220.90,20140101
CGG_GH15-AU,170,397.65,57,215.00,227,612.65,20140101
CGG_GH21-AU,400,681.20,17,42.60,417,723.80,20140101
CGG_GH23-AU,873,1370.10,58,158.60,931,1528.70,20140101
CGG_GH24-AU,1485,2431.90,74,188.20,1559,2620.10,20140101
CGG_GH31-AU,1440,2266.70,72,199.60,1512,2466.30,20140101
CGG_GH32-AU,1210,1989.65,83,234.80,1293,2224.45,20140101
CGG_GH33-AU,700,1451.90,61,237.20,761,1689.10,20140101
CGG_GH34-AU,867,1770.95,57,171.80,924,1942.75,20140101
CGG_GH36-AU,1007,2005.75,38,117.00,1045,2122.75,20140101
CGG_GHX1-AU,756,2137.15,78,311.80,834,2448.95,20140101
CGG_GHX3-AU,382,951.50,37,155.60,419,1107.10,20140101
CGG_GHX5-AU,285,781.10,46,214.80,331,995.90,20140101
CGG_GM11-AU,86,241.45,26,97.00,112,338.45,20140101
CGG_GM16-AU,148,412.30,40,155.00,188,567.30,20140101
CGG_HAY1-AU,483,2930.30,430,3180.45,913,6110.75,20140101
CGG_HAY2-AU,233,1281.85,556,4104.45,789,5386.30,20140101
CGG_HAY3-AU,1150,5618.25,869,6295.55,2019,11913.80,20140101
CGG_JSX1-AU,1004,2023.70,59,171.20,1063,2194.90,20140101
CGG_JSX2-AU,1209,2201.95,79,207.00,1288,2408.95,20140101
CGG_LM11-AU,848,1441.40,45,115.80,893,1557.20,20140101
CGG_LM12-AU,858,1317.05,42,135.80,900,1452.85,20140101
CGG_LM13-AU,400,624.45,38,107.20,438,731.65,20140101
CGG_LM14-AU,147,187.45,5,12.00,152,199.45,20140101
CGG_LM15-AU,383,675.75,23,61.00,406,736.75,20140101
CGG_LM16-AU,494,863.70,36,108.00,530,971.70,20140101
CGG_LM30-AU,999,1486.50,36,80.00,1035,1566.50,20140101
CGG_LM32-AU,1693,2600.35,84,202.20,1777,2802.55,20140101
CGG_LM41-AU,1001,1561.40,29,64.80,1030,1626.20,20140101
CGG_LM42-AU,889,1294.65,38,86.20,927,1380.85,20140101
CGG_LM43-AU,1481,1802.50,43,87.80,1524,1890.30,20140101
CGG_LM44-AU,1655,2203.85,55,138.80,1710,2342.65,20140101
CGG_LMX2-AU,160,603.75,63,635.20,223,1238.95,20140101
CGG_LR11-AU,806,1416.45,46,108.80,852,1525.25,20140101
CGG_LR12-AU,1172,2130.70,53,141.80,1225,2272.50,20140101
CGG_LR13-AU,2240,3753.80,97,242.80,2337,3996.60,20140101
CGG_LR14-AU,966,1666.10,77,184.00,1043,1850.10,20140101
CGG_LR15-AU,232,759.20,78,368.00,310,1127.20,20140101
CGG_LR16-AU,941,1807.70,76,217.20,1017,2024.90,20140101
CGG_LR31-AU,370,1173.85,52,236.20,422,1410.05,20140101
CGG_LR33-AU,630,2033.50,80,388.60,710,2422.10,20140101
CGG_LR43-AU,759,1885.30,41,140.00,800,2025.30,20140101
CGG_LR47-AU,1132,2971.50,96,395.60,1228,3367.10,20140101
CGG_MB11-AU,792,1542.90,35,93.80,827,1636.70,20140101
CGG_MB12-AU,1185,2250.35,75,204.80,1260,2455.15,20140101
CGG_MB13-AU,742,1300.40,18,44.20,760,1344.60,20140101
CGG_MB14-AU,838,1388.10,28,62.00,866,1450.10,20140101
CGG_MB15-AU,611,949.90,29,68.20,640,1018.10,20140101
CGG_MB16-AU,786,1275.10,29,71.00,815,1346.10,20140101
CGG_MB17-AU,1094,1642.35,58,144.00,1152,1786.35,20140101
CGG_MB23-AU,1352,2250.80,38,80.20,1390,2331.00,20140101
CGG_MB31-AU,2033,3011.35,88,212.40,2121,3223.75,20140101
CGG_MB32-AU,1861,2400.95,64,139.00,1925,2539.95,20140101
CGG_MB33-AU,1672,2511.45,80,174.20,1752,2685.65,20140101
CGG_MB34-AU,1772,2218.35,50,96.00,1822,2314.35,20140101
CGG_MB35-AU,1401,2421.35,80,228.40,1481,2649.75,20140101
CGG_MB36-AU,2443,3254.60,105,223.60,2548,3478.20,20140101
CGG_MB37-AU,1209,1967.70,48,114.20,1257,2081.90,20140101
CGG_MB38-AU,1932,2780.00,57,126.80,1989,2906.80,20140101
CGG_MB41-AU,1500,2373.20,66,173.60,1566,2546.80,20140101
CGG_MB42-AU,659,1338.95,33,93.80,692,1432.75,20140101
CGG_MB44-AU,1253,2388.65,55,171.40,1308,2560.05,20140101
CGG_MBX1-AU,1315,3132.65,79,241.20,1394,3373.85,20140101
CGG_MBX2-AU,1010,2269.65,103,305.20,1113,2574.85,20140101
CGG_MBX4-AU,755,1697.55,54,167.80,809,1865.35,20140101
CGG_MC21-AU,827,2038.20,79,563.60,906,2601.80,20140101
CGG_MC22-AU,756,1778.45,48,311.60,804,2090.05,20140101
CGG_MC23-AU,899,2153.00,55,350.55,954,2503.55,20140101
CGG_MK31-AU,347,1302.45,53,257.60,400,1560.05,20140101
CGG_MK34-AU,201,596.15,40,167.60,241,763.75,20140101
CGG_MK35-AU,152,446.35,24,108.00,176,554.35,20140101
CGG_MM41-AU,1952,2923.35,54,116.20,2006,3039.55,20140101
CGG_MS10-AU,454,685.50,25,64.60,479,750.10,20140101
CGG_MS11-AU,1033,1684.80,71,193.00,1104,1877.80,20140101
CGG_MS12-AU,1672,2333.05,56,142.00,1728,2475.05,20140101
CGG_MS21-AU,1456,2284.55,80,200.20,1536,2484.75,20140101
CGG_MS30-AU,628,960.20,29,69.20,657,1029.40,20140101
CGG_MS31-AU,2092,3622.70,99,247.80,2191,3870.50,20140101
CGG_MS32-AU,1285,2155.20,72,177.60,1357,2332.80,20140101
CGG_MS41-AU,861,1429.55,50,112.60,911,1542.15,20140101
CGG_MS42-AU,1644,2081.15,83,166.80,1727,2247.95,20140101
CGG_MS43-AU,1937,2878.80,64,140.40,2001,3019.20,20140101
CGG_MS44-AU,1482,2058.25,53,100.20,1535,2158.45,20140101
CGG_MS46-AU,1350,1796.20,44,85.80,1394,1882.00,20140101
CGG_MY21-AU,845,1348.85,27,61.80,872,1410.65,20140101
CGG_MY22-AU,171,373.10,8,21.00,179,394.10,20140101
CGG_MY23-AU,754,1377.75,21,52.20,775,1429.95,20140101
CGG_MY24-AU,0,0.00,0,0.00,0,0.00,20140101
CGG_MY25-AU,1147,2193.45,52,138.60,1199,2332.05,20140101
CGG_MY31-AU,551,1226.45,55,173.20,606,1399.65,20140101
CGG_MY32-AU,698,1471.20,54,159.00,752,1630.20,20140101
CGG_MY33-AU,320,796.80,32,111.00,352,907.80,20140101
CGG_MY34-AU,369,1013.10,27,92.80,396,1105.90,20140101
CGG_MY35-AU,307,775.50,19,63.60,326,839.10,20140101
CGG_MY41-AU,1400,2706.90,56,157.20,1456,2864.10,20140101
CGG_MY42-AU,2079,3414.65,102,253.40,2181,3668.05,20140101
CGG_MY43-AU,730,1816.45,33,90.20,763,1906.65,20140101
CGG_MY44-AU,367,945.80,20,72.00,387,1017.80,20140101
CGG_MY45-AU,736,1992.10,40,131.60,776,2123.70,20140101
CGG_MY46-AU,1616,4393.55,66,209.00,1682,4602.55,20140101
CGG_MY47-AU,1101,2898.80,57,175.60,1158,3074.40,20140101
CGG_MY51-AU,983,2824.85,104,483.80,1087,3308.65,20140101
CGG_MY52-AU,1028,3424.25,173,1061.80,1201,4486.05,20140101
CGG_MY53-AU,593,1826.45,82,374.20,675,2200.65,20140101
CGG_MY54-AU,851,3005.65,92,563.60,943,3569.25,20140101
CGG_MY55-AU,943,2943.75,98,466.80,1041,3410.55,20140101
CGG_MY56-AU,1002,3730.75,155,913.80,1157,4644.55,20140101
CGG_MY57-AU,924,2859.70,84,350.60,1008,3210.30,20140101
CGG_PNR1-AU,741,2234.35,236,708.00,977,2942.35,20140101
CGG_PNR2-AU,113,343.05,17,51.00,130,394.05,20140101
CGG_RBX4-AU,857,2682.40,76,282.00,933,2964.40,20140101
CGG_RBX5-AU,539,1821.10,89,344.00,628,2165.10,20140101
CGG_RBX6-AU,567,2011.25,189,739.00,756,2750.25,20140101
CGG_RBX7-AU,414,1422.65,108,425.00,522,1847.65,20140101
CGG_RS11-AU,681,828.35,18,44.80,699,873.15,20140101
CGG_RS13-AU,556,670.65,26,68.60,582,739.25,20140101
CGG_RS14-AU,1382,1374.75,24,50.20,1406,1424.95,20140101
CGG_RS15-AU,649,1059.35,54,157.20,703,1216.55,20140101
CGG_RS16-AU,1338,1592.50,52,118.60,1390,1711.10,20140101
CGG_RS20-AU,1290,1792.45,63,145.20,1353,1937.65,20140101
CGG_RS21-AU,1509,2180.35,52,126.00,1561,2306.35,20140101
CGG_RS22-AU,2356,3327.75,63,135.20,2419,3462.95,20140101
CGG_RS23-AU,1482,2195.60,65,137.80,1547,2333.40,20140101
CGG_RS30-AU,1324,2280.85,68,195.00,1392,2475.85,20140101
CGG_RS31-AU,1505,2692.15,75,180.40,1580,2872.55,20140101
CGG_RS32-AU,1033,2065.95,69,216.20,1102,2282.15,20140101
CGG_RS33-AU,1112,2037.35,44,111.60,1156,2148.95,20140101
CGG_RS41-AU,1249,2159.70,75,205.60,1324,2365.30,20140101
CGG_RS42-AU,1284,2569.65,70,214.60,1354,2784.25,20140101
CGG_RS43-AU,662,1166.15,42,107.40,704,1273.55,20140101
CGG_RS44-AU,523,1047.10,29,86.60,552,1133.70,20140101
CGG_RS45-AU,1345,2352.35,84,221.00,1429,2573.35,20140101
CGG_RS46-AU,796,1693.15,55,156.60,851,1849.75,20140101
CGG_RS50-AU,408,722.45,33,63.60,441,786.05,20140101
CGG_RS53-AU,811,1764.95,55,168.60,866,1933.55,20140101
CGG_RSX1-AU,251,372.95,3,10.00,254,382.95,20140101
CGG_RSX2-AU,515,895.55,20,53.00,535,948.55,20140101
CGG_RSX3-AU,391,840.90,14,40.60,405,881.50,20140101
CGG_RT12-AU,955,2163.50,63,246.60,1018,2410.10,20140101
CGG_SS31-AU,899,1439.40,39,161.80,938,1601.20,20140101
CGG_SS32-AU,676,1021.90,22,67.60,698,1089.50,20140101
CGG_SW30-AU,366,1026.55,59,460.00,425,1486.55,20140101
CGG_SW31-AU,1126,2717.15,74,239.80,1200,2956.95,20140101
CGG_SW32-AU,412,1110.10,85,796.00,497,1906.10,20140101
CGG_SW33-AU,507,1268.45,36,110.60,543,1379.05,20140101
CGG_SW34-AU,545,1821.25,135,1315.00,680,3136.25,20140101
CGG_SW35-AU,381,952.00,27,96.00,408,1048.00,20140101
CGG_TM10-AU,2066,4733.70,382,1371.55,2448,6105.25,20140101
CGG_TMX3-AU,986,3144.95,182,1059.65,1168,4204.60,20140101
CGG_TMX4-AU,1641,4918.70,224,1194.30,1865,6113.00,20140101
CGG_TMX5-AU,1648,4859.50,377,2348.65,2025,7208.15,20140101
CGG_TMX6-AU,1476,4484.10,346,2040.85,1822,6524.95,20140101
CGG_TMX7-AU,1495,3528.00,234,870.45,1729,4398.45,20140101
CGG_TMX8-AU,2190,5445.95,642,2425.70,2832,7871.65,20140101
CGG_TMX9-AU,2200,5033.10,307,1109.00,2507,6142.10,20140101
CGG_TPX1-AU,910,1551.25,147,444.50,1057,1995.75,20140101
CGG_US10-AU,1175,1834.05,19,46.60,1194,1880.65,20140101
CGG_WES1-AU,566,2360.60,94,509.45,660,2870.05,20140101
CGG_WES2-AU,836,3406.70,165,919.50,1001,4326.20,20140101
CGG_YA11-AU,680,1197.60,25,79.60,705,1277.20,20140101
CGG_YA13-AU,1738,2922.70,60,143.60,1798,3066.30,20140101
CGG_YA14-AU,1316,2288.85,64,144.40,1380,2433.25,20140101
CGG_YA15-AU,0,0.00,0,0.00,0,0.00,20140101
CGG_YA18-AU,973,1836.45,54,155.40,1027,1991.85,20140101
CGG_YA20-AU,1530,2863.70,56,147.20,1586,3010.90,20140101
CGG_YA21-AU,981,1622.00,27,65.80,1008,1687.80,20140101
CGG_YA23-AU,816,1517.40,33,78.00,849,1595.40,20140101
CGG_YA31-AU,1466,3212.95,69,193.40,1535,3406.35,20140101
CGG_YA32-AU,912,1962.60,71,229.20,983,2191.80,20140101
CGG_YA34-AU,763,2169.20,48,212.00,811,2381.20,20140101
CGG_YA35-AU,840,2562.20,57,292.00,897,2854.20,20140101
CGG_YA36-AU,545,1666.55,43,211.60,588,1878.15,20140101
CGG_YAX1-AU,961,2515.10,79,290.40,1040,2805.50,20140101
CGG_YAX2-AU,607,1561.70,42,158.00,649,1719.70,20140101
CGG_YAX3-AU,296,868.40,26,97.60,322,966.00,20140101
CGG_YAX4-AU,385,1025.35,30,132.00,415,1157.35,20140101
CGG_YCX1-AU,474,1126.10,44,160.00,518,1286.10,20140101
CGG_AP21-AU,503,1160.15,58,196.00,561,1356.15,20130701
CGG_BC21-AU,253,1264.40,155,1778.80,408,3043.20,20130701
CGG_BC41-AU,324,1168.55,152,748.00,476,1916.55,20130701
CGG_BC42-AU,150,575.05,72,350.60,222,925.65,20130701
CGG_BC43-AU,297,896.90,296,1455.00,593,2351.90,20130701
CGG_BR22-AU,518,1144.90,79,238.60,597,1383.50,20130701
CGG_BR23-AU,866,2180.25,118,509.20,984,2689.45,20130701
CGG_BR26-AU,934,1903.80,78,233.40,1012,2137.20,20130701
CGG_BR31-AU,919,2113.20,12,35.00,931,2148.20,20130701
CGG_BR32-AU,912,1782.10,45,129.20,957,1911.30,20130701
CGG_BR33-AU,393,871.75,21,75.00,414,946.75,20130701
CGG_BR34-AU,1406,2501.55,62,155.20,1468,2656.75,20130701
CGG_BR35-AU,816,1839.50,41,139.40,857,1978.90,20130701
CGG_BR41-AU,202,824.35,60,295.00,262,1119.35,20130701
CGG_BR42-AU,743,1723.15,99,363.60,842,2086.75,20130701
CGG_BR43-AU,103,412.95,102,508.00,205,920.95,20130701
CGG_BR44-AU,354,851.35,12,43.00,366,894.35,20130701
CGG_BR45-AU,108,486.60,80,392.00,188,878.60,20130701
CGG_BS11-AU,211,909.80,162,807.00,373,1716.80,20130701
CGG_BS12-AU,0,0.00,0,0.00,0,0.00,20130701
CGG_BS13-AU,163,746.00,151,748.00,314,1494.00,20130701
CGG_BS16-AU,173,757.75,79,392.00,252,1149.75,20130701
CGG_BS17-AU,572,1294.75,28,88.00,600,1382.75,20130701
CGG_BS18-AU,539,1378.50,64,289.00,603,1667.50,20130701
CGG_BS21-AU,1469,2780.35,60,170.80,1529,2951.15,20130701
CGG_BS22-AU,1078,1845.75,40,109.80,1118,1955.55,20130701
CGG_BS23-AU,1210,2460.80,55,163.80,1265,2624.60,20130701
CGG_BS24-AU,1236,2232.60,56,152.60,1292,2385.20,20130701
CGG_BS25-AU,1603,3288.35,82,242.80,1685,3531.15,20130701
CGG_BS26-AU,2110,4264.05,107,320.00,2217,4584.05,20130701
CGG_BS27-AU,2563,5815.20,90,257.00,2653,6072.20,20130701
CGG_BS29-AU,1283,3049.20,82,251.80,1365,3301.00,20130701
CGG_BS31-AU,1037,2511.70,58,187.40,1095,2699.10,20130701
CGG_BS32-AU,1310,3022.30,85,275.40,1395,3297.70,20130701
CGG_BS34-AU,243,555.55,6,18.00,249,573.55,20130701
CGG_BS35-AU,847,2060.40,39,132.00,886,2192.40,20130701
CGG_BS36-AU,2110,5172.75,136,446.40,2246,5619.15,20130701
CGG_BS37-AU,2168,5373.35,119,387.80,2287,5761.15,20130701
CGG_CCX1-AU,267,1434.95,163,1817.70,430,3252.65,20130701
CGG_CCX2-AU,351,1900.15,225,2272.10,576,4172.25,20130701
CGG_CCX3-AU,66,348.45,39,403.60,105,752.05,20130701
CGG_CCX4-AU,44,207.80,26,228.60,70,436.40,20130701
CGG_CCX5-AU,370,2399.75,191,2143.70,561,4543.45,20130701
CGG_CCX6-AU,94,594.35,106,1477.20,200,2071.55,20130701
CGG_CL11-AU,821,1667.30,91,295.60,912,1962.90,20130701
CGG_CLX2-AU,1077,2236.10,65,201.20,1142,2437.30,20130701
CGG_CPX1-AU,1896,5313.15,201,841.60,2097,6154.75,20130701
CGG_CPX2-AU,1018,2633.25,120,466.20,1138,3099.45,20130701
CGG_CS21-AU,1013,2736.60,218,1016.60,1231,3753.20,20130701
CGG_CS22-AU,845,1692.20,85,244.60,930,1936.80,20130701
CGG_EB29-AU,541,1364.10,31,123.60,572,1487.70,20130701
CGG_EB31-AU,790,2004.40,50,177.60,840,2182.00,20130701
CGG_EB32-AU,903,2161.00,74,262.60,977,2423.60,20130701
CGG_EB33-AU,1692,4204.05,116,414.20,1808,4618.25,20130701
CGG_EB34-AU,1243,2619.35,54,199.40,1297,2818.75,20130701
CGG_EB35-AU,1288,3369.65,93,378.60,1381,3748.25,20130701
CGG_EB36-AU,1411,3568.15,94,333.60,1505,3901.75,20130701
CGG_EB41-AU,644,1979.95,60,357.00,704,2336.95,20130701
CGG_EB42-AU,164,692.05,94,463.00,258,1155.05,20130701
CGG_EB44-AU,107,459.20,133,661.00,240,1120.20,20130701
CGG_EB46-AU,102,419.70,99,491.00,201,910.70,20130701
CGG_FM21-AU,466,1676.55,117,1037.65,583,2714.20,20130701
CGG_FM22-AU,432,1748.10,205,2170.20,637,3918.30,20130701
CGG_FM23-AU,369,1560.40,277,2955.20,646,4515.60,20130701
CGG_FM24-AU,352,1329.35,207,2251.10,559,3580.45,20130701
CGG_FS21-AU,360,1285.15,102,1019.05,462,2304.20,20130701
CGG_FS22-AU,307,889.30,51,225.60,358,1114.90,20130701
CGG_FS23-AU,147,580.15,97,1104.00,244,1684.15,20130701
CGG_FS24-AU,357,1003.45,46,217.80,403,1221.25,20130701
CGG_FS25-AU,339,944.30,72,355.60,411,1299.90,20130701
CGG_FS26-AU,397,1150.65,51,233.60,448,1384.25,20130701
CGG_FS31-AU,923,1729.95,62,192.80,985,1922.75,20130701
CGG_FS32-AU,1075,2178.35,92,271.40,1167,2449.75,20130701
CGG_FS33-AU,2170,3792.80,83,218.80,2253,4011.60,20130701
CGG_GC13-AU,283,1047.75,101,498.00,384,1545.75,20130701
CGG_GH15-AU,314,702.25,44,153.60,358,855.85,20130701
CGG_GH21-AU,538,1016.80,25,73.80,563,1090.60,20130701
CGG_GH23-AU,1338,2288.05,99,266.20,1437,2554.25,20130701
CGG_GH24-AU,1489,1954.95,49,87.40,1538,2042.35,20130701
CGG_GH31-AU,1739,2190.05,53,78.80,1792,2268.85,20130701
CGG_GH32-AU,1296,1756.00,66,120.00,1362,1876.00,20130701
CGG_GH33-AU,1017,2028.00,43,138.20,1060,2166.20,20130701
CGG_GH34-AU,1046,2154.25,90,280.40,1136,2434.65,20130701
CGG_GH36-AU,1400,2904.60,50,146.20,1450,3050.80,20130701
CGG_GHX1-AU,1037,2867.30,145,663.60,1182,3530.90,20130701
CGG_GHX3-AU,1201,3419.25,297,1403.80,1498,4823.05,20130701
CGG_GHX5-AU,0,0.00,0,0.00,0,0.00,20130701
CGG_GM11-AU,234,660.30,37,131.00,271,791.30,20130701
CGG_GM16-AU,231,592.25,48,165.00,279,757.25,20130701
CGG_HAY1-AU,287,1772.75,475,3458.20,762,5230.95,20130701
CGG_HAY2-AU,754,4255.45,568,4132.00,1322,8387.45,20130701
CGG_HAY3-AU,1355,6812.35,1048,7510.45,2403,14322.80,20130701
CGG_JSX1-AU,1320,2861.40,101,298.80,1421,3160.20,20130701
CGG_JSX2-AU,1669,2460.65,76,135.00,1745,2595.65,20130701
CGG_LM11-AU,1103,2039.85,56,180.80,1159,2220.65,20130701
CGG_LM12-AU,961,1663.70,54,164.80,1015,1828.50,20130701
CGG_LM13-AU,892,1439.55,45,125.00,937,1564.55,20130701
CGG_LM14-AU,616,1030.05,36,108.80,652,1138.85,20130701
CGG_LM15-AU,579,1191.05,53,180.60,632,1371.65,20130701
CGG_LM16-AU,775,1624.50,74,250.20,849,1874.70,20130701
CGG_LM30-AU,1322,1734.30,54,88.00,1376,1822.30,20130701
CGG_LM32-AU,2592,3371.60,76,124.60,2668,3496.20,20130701
CGG_LM41-AU,1125,1930.65,53,123.20,1178,2053.85,20130701
CGG_LM42-AU,1014,1547.70,5,9.60,1019,1557.30,20130701
CGG_LM43-AU,1741,2050.60,48,127.40,1789,2178.00,20130701
CGG_LM44-AU,1859,2464.85,54,154.00,1913,2618.85,20130701
CGG_LMX2-AU,363,1543.35,117,1075.25,480,2618.60,20130701
CGG_LR11-AU,845,1578.80,47,128.20,892,1707.00,20130701
CGG_LR12-AU,1355,2361.05,67,164.80,1422,2525.85,20130701
CGG_LR13-AU,2252,3956.00,130,390.40,2382,4346.40,20130701
CGG_LR14-AU,1008,1810.10,47,124.00,1055,1934.10,20130701
CGG_LR15-AU,260,850.50,93,439.00,353,1289.50,20130701
CGG_LR16-AU,1066,2105.35,87,258.00,1153,2363.35,20130701
CGG_LR31-AU,391,1101.85,55,262.60,446,1364.45,20130701
CGG_LR33-AU,637,1878.55,98,471.00,735,2349.55,20130701
CGG_LR43-AU,865,2044.00,56,191.80,921,2235.80,20130701
CGG_LR47-AU,1472,3772.55,102,417.20,1574,4189.75,20130701
CGG_MB11-AU,1011,1934.15,36,108.80,1047,2042.95,20130701
CGG_MB12-AU,1399,2709.50,77,232.80,1476,2942.30,20130701
CGG_MB13-AU,944,1822.05,29,90.60,973,1912.65,20130701
CGG_MB14-AU,1261,1675.35,14,20.40,1275,1695.75,20130701
CGG_MB15-AU,926,1231.05,35,59.80,961,1290.85,20130701
CGG_MB16-AU,1153,1475.85,43,64.80,1196,1540.65,20130701
CGG_MB17-AU,1659,2162.80,59,102.60,1718,2265.40,20130701
CGG_MB23-AU,1954,2390.15,47,74.20,2001,2464.35,20130701
CGG_MB31-AU,2216,3409.90,101,283.00,2317,3692.90,20130701
CGG_MB32-AU,1876,2198.70,43,64.80,1919,2263.50,20130701
CGG_MB33-AU,2023,2996.65,59,153.00,2082,3149.65,20130701
CGG_MB34-AU,2165,2419.90,37,49.80,2202,2469.70,20130701
CGG_MB35-AU,1429,2281.60,55,125.80,1484,2407.40,20130701
CGG_MB36-AU,2864,3023.10,110,155.60,2974,3178.70,20130701
CGG_MB37-AU,949,1447.50,31,67.40,980,1514.90,20130701
CGG_MB38-AU,2367,2916.80,57,81.00,2424,2997.80,20130701
CGG_MB41-AU,1904,3078.95,87,227.00,1991,3305.95,20130701
CGG_MB42-AU,1408,2806.10,65,191.20,1473,2997.30,20130701
CGG_MB44-AU,1731,3392.30,82,230.60,1813,3622.90,20130701
CGG_MBX1-AU,1250,2896.30,93,268.00,1343,3164.30,20130701
CGG_MBX2-AU,1187,2710.75,90,263.60,1277,2974.35,20130701
CGG_MBX4-AU,887,1862.35,60,181.60,947,2043.95,20130701
CGG_MC21-AU,1075,2712.85,106,672.50,1181,3385.35,20130701
CGG_MC22-AU,654,1628.40,69,441.90,723,2070.30,20130701
CGG_MC23-AU,701,1720.95,57,397.50,758,2118.45,20130701
CGG_MK31-AU,312,1113.90,31,132.60,343,1246.50,20130701
CGG_MK34-AU,213,600.25,22,106.00,235,706.25,20130701
CGG_MK35-AU,139,451.55,19,83.00,158,534.55,20130701
CGG_MM41-AU,2501,3683.90,101,229.60,2602,3913.50,20130701
CGG_MS10-AU,633,762.75,33,58.00,666,820.75,20130701
CGG_MS11-AU,1306,2267.20,86,237.40,1392,2504.60,20130701
CGG_MS12-AU,2084,2584.40,77,115.20,2161,2699.60,20130701
CGG_MS21-AU,2006,2616.15,94,159.20,2100,2775.35,20130701
CGG_MS30-AU,920,1141.00,30,46.60,950,1187.60,20130701
CGG_MS31-AU,2930,4120.75,154,253.60,3084,4374.35,20130701
CGG_MS32-AU,1621,2194.55,81,125.40,1702,2319.95,20130701
CGG_MS41-AU,1275,1690.45,45,66.60,1320,1757.05,20130701
CGG_MS42-AU,2394,2488.20,74,98.60,2468,2586.80,20130701
CGG_MS43-AU,2204,3178.35,73,152.20,2277,3330.55,20130701
CGG_MS44-AU,1827,2391.20,61,112.20,1888,2503.40,20130701
CGG_MS46-AU,1643,2072.25,40,79.40,1683,2151.65,20130701
CGG_MY21-AU,1007,1750.75,33,87.40,1040,1838.15,20130701
CGG_MY22-AU,277,579.55,12,35.00,289,614.55,20130701
CGG_MY23-AU,921,1653.90,24,62.40,945,1716.30,20130701
CGG_MY24-AU,0,0.00,0,0.00,0,0.00,20130701
CGG_MY25-AU,1385,2676.20,63,188.40,1448,2864.60,20130701
CGG_MY26-AU,0,0.00,0,0.00,0,0.00,20130701
CGG_MY31-AU,692,1424.10,71,231.80,763,1655.90,20130701
CGG_MY32-AU,811,1766.40,54,150.60,865,1917.00,20130701
CGG_MY33-AU,393,858.05,43,146.60,436,1004.65,20130701
CGG_MY34-AU,484,1263.25,17,60.00,501,1323.25,20130701
CGG_MY35-AU,315,724.60,26,84.60,341,809.20,20130701
CGG_MY41-AU,1955,3653.20,71,195.20,2026,3848.40,20130701
CGG_MY42-AU,2702,4547.55,105,271.20,2807,4818.75,20130701
CGG_MY43-AU,916,2186.75,51,148.60,967,2335.35,20130701
CGG_MY44-AU,482,1246.20,33,103.60,515,1349.80,20130701
CGG_MY45-AU,824,2166.50,64,208.60,888,2375.10,20130701
CGG_MY46-AU,1964,5243.60,92,298.80,2056,5542.40,20130701
CGG_MY47-AU,1495,3832.25,85,276.00,1580,4108.25,20130701
CGG_MY51-AU,1198,3497.40,118,520.80,1316,4018.20,20130701
CGG_MY52-AU,1241,4134.90,246,1572.60,1487,5707.50,20130701
CGG_MY53-AU,807,2369.80,105,514.00,912,2883.80,20130701
CGG_MY54-AU,1714,6082.30,236,1411.40,1950,7493.70,20130701
CGG_MY55-AU,1469,4444.05,157,704.20,1626,5148.25,20130701
CGG_MY56-AU,0,0.00,0,0.00,0,0.00,20130701
CGG_MY57-AU,1684,5248.60,182,790.00,1866,6038.60,20130701
CGG_PNR1-AU,1047,3155.35,280,840.00,1327,3995.35,20130701
CGG_PNR2-AU,134,233.85,2,6.00,136,239.85,20130701
CGG_RBX4-AU,25,53.80,2,5.00,27,58.80,20130701
CGG_RBX5-AU,250,854.40,56,221.00,306,1075.40,20130701
CGG_RBX6-AU,460,1777.90,209,835.00,669,2612.90,20130701
CGG_RBX7-AU,355,1331.35,162,646.00,517,1977.35,20130701
CGG_RS11-AU,901,1036.30,12,19.60,913,1055.90,20130701
CGG_RS13-AU,695,809.10,40,70.00,735,879.10,20130701
CGG_RS14-AU,1837,1982.05,61,132.80,1898,2114.85,20130701
CGG_RS15-AU,986,1263.90,66,118.40,1052,1382.30,20130701
CGG_RS16-AU,1707,2368.10,98,294.40,1805,2662.50,20130701
CGG_RS20-AU,1655,2297.40,55,111.80,1710,2409.20,20130701
CGG_RS21-AU,1844,2324.75,72,108.60,1916,2433.35,20130701
CGG_RS22-AU,2725,3780.20,106,262.80,2831,4043.00,20130701
CGG_RS23-AU,2049,2508.55,81,135.60,2130,2644.15,20130701
CGG_RS30-AU,1594,2580.65,94,252.60,1688,2833.25,20130701
CGG_RS31-AU,2189,2825.20,81,127.80,2270,2953.00,20130701
CGG_RS32-AU,1317,2437.50,104,336.00,1421,2773.50,20130701
CGG_RS33-AU,1429,1911.30,44,73.40,1473,1984.70,20130701
CGG_RS41-AU,1596,2760.60,65,172.60,1661,2933.20,20130701
CGG_RS42-AU,1552,3080.05,73,205.80,1625,3285.85,20130701
CGG_RS43-AU,896,1642.75,59,172.00,955,1814.75,20130701
CGG_RS44-AU,637,1249.30,35,96.60,672,1345.90,20130701
CGG_RS45-AU,1766,3115.60,87,216.20,1853,3331.80,20130701
CGG_RS46-AU,1086,2262.10,53,149.80,1139,2411.90,20130701
CGG_RS50-AU,517,889.00,18,33.00,535,922.00,20130701
CGG_RS53-AU,940,2102.60,61,188.00,1001,2290.60,20130701
CGG_RSX1-AU,171,329.70,6,15.60,177,345.30,20130701
CGG_RSX2-AU,132,229.50,6,21.00,138,250.50,20130701
CGG_RSX3-AU,522,1115.60,41,140.00,563,1255.60,20130701
CGG_RT12-AU,1077,2598.05,56,248.20,1133,2846.25,20130701
CGG_SS31-AU,730,1468.50,58,243.20,788,1711.70,20130701
CGG_SS32-AU,589,1157.65,35,150.20,624,1307.85,20130701
CGG_SW30-AU,407,1246.85,73,679.00,480,1925.85,20130701
CGG_SW31-AU,1411,3311.95,75,244.20,1486,3556.15,20130701
CGG_SW32-AU,427,1406.30,79,885.00,506,2291.30,20130701
CGG_SW33-AU,587,1490.05,46,168.60,633,1658.65,20130701
CGG_SW34-AU,664,2435.75,149,1380.00,813,3815.75,20130701
CGG_SW35-AU,651,1678.20,47,161.00,698,1839.20,20130701
CGG_TM10-AU,2632,6043.35,380,1341.25,3012,7384.60,20130701
CGG_TMX3-AU,1069,3473.55,226,1211.65,1295,4685.20,20130701
CGG_TMX4-AU,1933,6057.80,321,1658.35,2254,7716.15,20130701
CGG_TMX5-AU,1993,5898.10,354,1993.00,2347,7891.10,20130701
CGG_TMX6-AU,1957,5914.75,466,2577.85,2423,8492.60,20130701
CGG_TMX7-AU,886,2156.70,128,467.25,1014,2623.95,20130701
CGG_TMX8-AU,2968,6956.05,923,3480.60,3891,10436.65,20130701
CGG_TMX9-AU,3423,7645.70,568,2016.80,3991,9662.50,20130701
CGG_TPX1-AU,1387,2705.10,183,547.95,1570,3253.05,20130701
CGG_US10-AU,1316,1779.60,35,56.40,1351,1836.00,20130701
CGG_WES1-AU,675,2700.00,105,548.70,780,3248.70,20130701
CGG_WES2-AU,992,3727.15,217,1138.60,1209,4865.75,20130701
CGG_YA11-AU,922,1291.25,32,49.60,954,1340.85,20130701
CGG_YA13-AU,2090,2867.05,72,105.80,2162,2972.85,20130701
CGG_YA14-AU,1826,2460.30,86,141.80,1912,2602.10,20130701
CGG_YA15-AU,655,913.35,17,29.60,672,942.95,20130701
CGG_YA18-AU,1260,1883.90,58,97.60,1318,1981.50,20130701
CGG_YA20-AU,2023,2917.90,57,97.40,2080,3015.30,20130701
CGG_YA21-AU,1246,1724.35,35,60.20,1281,1784.55,20130701
CGG_YA23-AU,1072,1550.30,32,57.20,1104,1607.50,20130701
CGG_YA31-AU,1541,3434.30,84,261.60,1625,3695.90,20130701
CGG_YA32-AU,1252,2635.70,72,225.20,1324,2860.90,20130701
CGG_YA34-AU,934,2286.50,74,373.60,1008,2660.10,20130701
CGG_YA35-AU,961,2657.40,90,399.80,1051,3057.20,20130701
CGG_YA36-AU,498,1280.70,72,299.40,570,1580.10,20130701
CGG_YAX1-AU,885,2299.50,67,218.80,952,2518.30,20130701
CGG_YAX2-AU,747,1856.30,51,179.20,798,2035.50,20130701
CGG_YAX3-AU,286,838.30,26,102.00,312,940.30,20130701
CGG_YAX4-AU,391,976.45,33,145.00,424,1121.45,20130701
CGG_YCX1-AU,225,513.25,21,81.00,246,594.25,20130701
CGG_AP21-AU,559,1303.80,73,253.60,632,1557.40,20130801
CGG_BC21-AU,298,1361.80,160,1841.35,458,3203.15,20130801
CGG_BC41-AU,367,1286.85,179,878.00,546,2164.85,20130801
CGG_BC42-AU,148,559.95,99,493.00,247,1052.95,20130801
CGG_BC43-AU,212,841.90,274,1344.20,486,2186.10,20130801
CGG_BR22-AU,544,1180.65,74,233.40,618,1414.05,20130801
CGG_BR23-AU,876,2210.20,145,646.00,1021,2856.20,20130801
CGG_BR26-AU,960,1901.10,73,232.00,1033,2133.10,20130801
CGG_BR31-AU,969,2231.95,4,9.00,973,2240.95,20130801
CGG_BR32-AU,973,1817.45,33,78.80,1006,1896.25,20130801
CGG_BR33-AU,353,778.40,41,172.00,394,950.40,20130801
CGG_BR34-AU,1787,3160.55,63,149.40,1850,3309.95,20130801
CGG_BR35-AU,1023,2285.30,52,189.00,1075,2474.30,20130801
CGG_BR41-AU,177,706.25,39,184.00,216,890.25,20130801
CGG_BR42-AU,630,1489.45,102,370.00,732,1859.45,20130801
CGG_BR43-AU,96,390.40,71,351.00,167,741.40,20130801
CGG_BR44-AU,265,633.60,20,73.00,285,706.60,20130801
CGG_BR45-AU,93,406.75,98,484.00,191,890.75,20130801
CGG_BS11-AU,152,688.80,187,935.00,339,1623.80,20130801
CGG_BS12-AU,0,0.00,0,0.00,0,0.00,20130801
CGG_BS13-AU,179,806.95,127,628.00,306,1434.95,20130801
CGG_BS16-AU,150,662.55,82,408.00,232,1070.55,20130801
CGG_BS17-AU,453,1166.25,73,518.00,526,1684.25,20130801
CGG_BS18-AU,609,1403.35,74,334.00,683,1737.35,20130801
CGG_BS21-AU,1624,3074.35,84,245.60,1708,3319.95,20130801
CGG_BS22-AU,1122,1886.40,58,154.40,1180,2040.80,20130801
CGG_BS23-AU,1313,2512.90,67,179.20,1380,2692.10,20130801
CGG_BS24-AU,1273,2327.95,73,195.80,1346,2523.75,20130801
CGG_BS25-AU,1545,3132.60,94,269.80,1639,3402.40,20130801
CGG_BS26-AU,2152,4393.50,121,349.40,2273,4742.90,20130801
CGG_BS27-AU,2613,5793.05,128,392.20,2741,6185.25,20130801
CGG_BS29-AU,1050,2674.55,73,244.20,1123,2918.75,20130801
CGG_BS31-AU,895,2161.70,56,182.80,951,2344.50,20130801
CGG_BS32-AU,1321,3149.40,92,287.40,1413,3436.80,20130801
CGG_BS34-AU,184,459.70,5,16.60,189,476.30,20130801
CGG_BS35-AU,818,2065.75,37,120.20,855,2185.95,20130801
CGG_BS36-AU,2127,5207.45,137,446.00,2264,5653.45,20130801
CGG_BS37-AU,2137,5339.90,112,354.40,2249,5694.30,20130801
CGG_CCX1-AU,277,1582.25,231,2796.80,508,4379.05,20130801
CGG_CCX2-AU,368,2224.05,281,3021.20,649,5245.25,20130801
CGG_CCX3-AU,101,553.95,82,867.60,183,1421.55,20130801
CGG_CCX4-AU,87,476.00,77,785.70,164,1261.70,20130801
CGG_CCX5-AU,464,3224.75,261,2983.70,725,6208.45,20130801
CGG_CCX6-AU,103,876.45,107,1449.00,210,2325.45,20130801
CGG_CL11-AU,922,1909.85,98,315.60,1020,2225.45,20130801
CGG_CLX2-AU,1014,2067.85,66,214.60,1080,2282.45,20130801
CGG_CPX1-AU,1481,4105.65,200,846.60,1681,4952.25,20130801
CGG_CPX2-AU,693,1804.20,110,457.60,803,2261.80,20130801
CGG_CS21-AU,891,2539.80,191,932.20,1082,3472.00,20130801
CGG_CS22-AU,694,1414.90,60,162.40,754,1577.30,20130801
CGG_EB29-AU,484,1255.25,39,147.00,523,1402.25,20130801
CGG_EB31-AU,659,1631.70,45,161.00,704,1792.70,20130801
CGG_EB32-AU,885,2056.50,93,354.20,978,2410.70,20130801
CGG_EB33-AU,1589,3794.90,113,443.60,1702,4238.50,20130801
CGG_EB34-AU,1183,2476.85,42,130.60,1225,2607.45,20130801
CGG_EB35-AU,1107,2885.35,121,477.20,1228,3362.55,20130801
CGG_EB36-AU,1148,2901.05,52,198.60,1200,3099.65,20130801
CGG_EB41-AU,504,1685.15,64,436.00,568,2121.15,20130801
CGG_EB42-AU,128,555.15,88,438.00,216,993.15,20130801
CGG_EB44-AU,107,478.50,113,565.00,220,1043.50,20130801
CGG_EB46-AU,81,329.15,116,580.00,197,909.15,20130801
CGG_FM21-AU,536,2503.45,240,2315.10,776,4818.55,20130801
CGG_FM22-AU,387,1798.40,244,2561.50,631,4359.90,20130801
CGG_FM23-AU,374,1568.55,283,3036.75,657,4605.30,20130801
CGG_FM24-AU,386,1726.30,225,2603.05,611,4329.35,20130801
CGG_FS21-AU,285,1294.30,109,1080.05,394,2374.35,20130801
CGG_FS22-AU,286,863.50,71,371.60,357,1235.10,20130801
CGG_FS23-AU,164,721.65,136,1546.30,300,2267.95,20130801
CGG_FS24-AU,449,1378.90,68,338.60,517,1717.50,20130801
CGG_FS25-AU,334,1069.60,74,376.00,408,1445.60,20130801
CGG_FS26-AU,398,1307.50,64,311.20,462,1618.70,20130801
CGG_FS31-AU,959,1811.75,49,153.20,1008,1964.95,20130801
CGG_FS32-AU,1201,2432.20,90,271.60,1291,2703.80,20130801
CGG_FS33-AU,2054,3578.20,78,214.80,2132,3793.00,20130801
CGG_GC13-AU,271,1011.20,126,615.00,397,1626.20,20130801
CGG_GH15-AU,298,734.00,39,141.60,337,875.60,20130801
CGG_GH21-AU,502,923.00,36,107.20,538,1030.20,20130801
CGG_GH23-AU,1294,2144.90,98,254.60,1392,2399.50,20130801
CGG_GH24-AU,2037,2731.35,87,149.60,2124,2880.95,20130801
CGG_GH31-AU,1449,1822.55,78,123.60,1527,1946.15,20130801
CGG_GH32-AU,1257,1714.80,67,120.80,1324,1835.60,20130801
CGG_GH33-AU,1153,2308.05,38,122.00,1191,2430.05,20130801
CGG_GH34-AU,1079,2297.55,90,304.60,1169,2602.15,20130801
CGG_GH36-AU,1371,2844.85,68,196.60,1439,3041.45,20130801
CGG_GHX1-AU,1072,3279.05,228,1058.00,1300,4337.05,20130801
CGG_GHX3-AU,1323,3912.65,312,1473.20,1635,5385.85,20130801
CGG_GHX5-AU,0,0.00,0,0.00,0,0.00,20130801
CGG_GM11-AU,231,651.50,41,136.80,272,788.30,20130801
CGG_GM16-AU,209,553.10,40,154.60,249,707.70,20130801
CGG_HAY1-AU,333,1972.10,532,3886.65,865,5858.75,20130801
CGG_HAY2-AU,666,3776.85,611,4452.15,1277,8229.00,20130801
CGG_HAY3-AU,1750,8594.25,1301,9378.90,3051,17973.15,20130801
CGG_JSX1-AU,1309,2734.45,126,388.20,1435,3122.65,20130801
CGG_JSX2-AU,1362,2031.50,91,149.20,1453,2180.70,20130801
CGG_LM11-AU,1139,2201.40,85,251.00,1224,2452.40,20130801
CGG_LM12-AU,937,1721.30,68,197.20,1005,1918.50,20130801
CGG_LM13-AU,910,1582.10,46,140.60,956,1722.70,20130801
CGG_LM14-AU,597,970.15,47,160.20,644,1130.35,20130801
CGG_LM15-AU,653,1377.30,58,198.60,711,1575.90,20130801
CGG_LM16-AU,903,1881.45,76,255.60,979,2137.05,20130801
CGG_LM30-AU,1402,1779.75,48,77.00,1450,1856.75,20130801
CGG_LM32-AU,2605,3377.40,89,144.20,2694,3521.60,20130801
CGG_LM41-AU,1127,1892.95,55,153.80,1182,2046.75,20130801
CGG_LM42-AU,1072,1668.90,16,31.80,1088,1700.70,20130801
CGG_LM43-AU,1933,2196.60,60,115.60,1993,2312.20,20130801
CGG_LM44-AU,2026,2834.60,75,195.20,2101,3029.80,20130801
CGG_LMX2-AU,362,1862.50,169,1753.20,531,3615.70,20130801
CGG_LR11-AU,826,1534.60,42,129.60,868,1664.20,20130801
CGG_LR12-AU,1362,2406.80,63,165.60,1425,2572.40,20130801
CGG_LR13-AU,2012,3726.65,123,353.80,2135,4080.45,20130801
CGG_LR14-AU,956,1690.20,53,155.60,1009,1845.80,20130801
CGG_LR15-AU,181,660.45,102,502.00,283,1162.45,20130801
CGG_LR16-AU,940,1843.90,139,414.20,1079,2258.10,20130801
CGG_LR31-AU,346,869.70,71,330.20,417,1199.90,20130801
CGG_LR33-AU,570,1331.40,31,130.60,601,1462.00,20130801
CGG_LR43-AU,923,2162.45,59,201.60,982,2364.05,20130801
CGG_LR47-AU,1298,3491.85,110,473.60,1408,3965.45,20130801
CGG_MB11-AU,1005,1893.30,38,115.00,1043,2008.30,20130801
CGG_MB12-AU,1462,2778.10,105,291.20,1567,3069.30,20130801
CGG_MB13-AU,963,1795.60,30,89.20,993,1884.80,20130801
CGG_MB14-AU,1146,1524.25,27,44.00,1173,1568.25,20130801
CGG_MB15-AU,892,1180.05,27,42.80,919,1222.85,20130801
CGG_MB16-AU,1121,1477.15,44,76.20,1165,1553.35,20130801
CGG_MB17-AU,1664,2123.85,72,114.80,1736,2238.65,20130801
CGG_MB23-AU,1944,2401.05,52,75.80,1996,2476.85,20130801
CGG_MB31-AU,2512,3591.35,90,221.80,2602,3813.15,20130801
CGG_MB32-AU,2067,2400.50,65,91.80,2132,2492.30,20130801
CGG_MB33-AU,2025,2846.60,75,181.20,2100,3027.80,20130801
CGG_MB34-AU,1981,2147.55,38,54.20,2019,2201.75,20130801
CGG_MB35-AU,1294,2018.05,47,126.80,1341,2144.85,20130801
CGG_MB36-AU,2992,3221.25,66,95.60,3058,3316.85,20130801
CGG_MB37-AU,1026,1457.25,34,81.60,1060,1538.85,20130801
CGG_MB38-AU,2405,3054.05,62,91.20,2467,3145.25,20130801
CGG_MB41-AU,2078,3385.75,88,231.00,2166,3616.75,20130801
CGG_MB42-AU,1515,3232.35,67,198.80,1582,3431.15,20130801
CGG_MB44-AU,1846,3757.70,62,170.20,1908,3927.90,20130801
CGG_MBX1-AU,1270,2908.25,86,254.60,1356,3162.85,20130801
CGG_MBX2-AU,1079,2377.05,104,323.60,1183,2700.65,20130801
CGG_MBX4-AU,893,1838.50,85,247.80,978,2086.30,20130801
CGG_MC21-AU,1130,3006.20,124,910.00,1254,3916.20,20130801
CGG_MC22-AU,670,1623.40,41,299.50,711,1922.90,20130801
CGG_MC23-AU,804,1841.05,66,444.60,870,2285.65,20130801
CGG_MK31-AU,221,665.25,24,117.60,245,782.85,20130801
CGG_MK34-AU,205,609.70,22,98.60,227,708.30,20130801
CGG_MK35-AU,109,313.90,21,100.00,130,413.90,20130801
CGG_MM41-AU,2429,3682.10,108,228.00,2537,3910.10,20130801
CGG_MS10-AU,654,809.15,30,56.00,684,865.15,20130801
CGG_MS11-AU,1289,2269.80,75,216.80,1364,2486.60,20130801
CGG_MS12-AU,2228,2657.10,69,108.80,2297,2765.90,20130801
CGG_MS21-AU,2043,2551.85,87,141.00,2130,2692.85,20130801
CGG_MS30-AU,979,1233.05,47,72.00,1026,1305.05,20130801
CGG_MS31-AU,2893,4089.80,149,249.20,3042,4339.00,20130801
CGG_MS32-AU,1806,2504.90,84,136.60,1890,2641.50,20130801
CGG_MS41-AU,1319,1755.65,43,62.60,1362,1818.25,20130801
CGG_MS42-AU,2304,2409.65,94,124.20,2398,2533.85,20130801
CGG_MS43-AU,2070,3068.95,73,163.20,2143,3232.15,20130801
CGG_MS44-AU,1902,2500.70,58,130.80,1960,2631.50,20130801
CGG_MS46-AU,1619,2060.05,44,88.00,1663,2148.05,20130801
CGG_MY21-AU,1093,2013.55,42,115.20,1135,2128.75,20130801
CGG_MY22-AU,371,766.00,15,43.00,386,809.00,20130801
CGG_MY23-AU,930,1742.45,43,126.80,973,1869.25,20130801
CGG_MY24-AU,0,0.00,0,0.00,0,0.00,20130801
CGG_MY25-AU,1422,2665.60,71,209.20,1493,2874.80,20130801
CGG_MY31-AU,672,1320.55,73,236.60,745,1557.15,20130801
CGG_MY32-AU,905,1889.45,65,185.80,970,2075.25,20130801
CGG_MY33-AU,420,934.40,44,145.80,464,1080.20,20130801
CGG_MY34-AU,510,1236.50,25,95.00,535,1331.50,20130801
CGG_MY35-AU,345,773.60,24,79.00,369,852.60,20130801
CGG_MY41-AU,1954,3684.20,87,228.00,2041,3912.20,20130801
CGG_MY42-AU,2817,4731.10,136,347.20,2953,5078.30,20130801
CGG_MY43-AU,1013,2446.55,54,165.60,1067,2612.15,20130801
CGG_MY44-AU,533,1348.40,20,56.20,553,1404.60,20130801
CGG_MY45-AU,975,2538.20,70,216.60,1045,2754.80,20130801
CGG_MY46-AU,2035,5467.40,105,340.80,2140,5808.20,20130801
CGG_MY47-AU,1453,3883.95,97,328.00,1550,4211.95,20130801
CGG_MY51-AU,1274,3878.70,99,451.60,1373,4330.30,20130801
CGG_MY52-AU,1303,4254.70,227,1418.60,1530,5673.30,20130801
CGG_MY53-AU,694,2159.60,69,302.60,763,2462.20,20130801
CGG_MY54-AU,1155,4144.55,172,1018.00,1327,5162.55,20130801
CGG_MY55-AU,1402,4239.30,146,654.00,1548,4893.30,20130801
CGG_MY56-AU,1175,4272.15,188,1111.40,1363,5383.55,20130801
CGG_MY57-AU,1402,4322.50,164,704.60,1566,5027.10,20130801
CGG_PNR1-AU,973,2937.90,289,867.00,1262,3804.90,20130801
CGG_PNR2-AU,129,394.10,2,6.00,131,400.10,20130801
CGG_RBX4-AU,0,0.00,0,0.00,0,0.00,20130801
CGG_RBX5-AU,182,649.95,56,222.00,238,871.95,20130801
CGG_RBX6-AU,447,1760.55,226,901.00,673,2661.55,20130801
CGG_RBX7-AU,318,1218.05,158,632.00,476,1850.05,20130801
CGG_RS11-AU,957,1134.40,32,48.80,989,1183.20,20130801
CGG_RS13-AU,769,912.00,28,49.60,797,961.60,20130801
CGG_RS14-AU,1725,2087.10,61,144.00,1786,2231.10,20130801
CGG_RS15-AU,1111,1476.00,75,129.80,1186,1605.80,20130801
CGG_RS16-AU,1743,2420.00,110,335.60,1853,2755.60,20130801
CGG_RS20-AU,1697,2358.95,44,105.20,1741,2464.15,20130801
CGG_RS21-AU,1932,2408.20,67,109.00,1999,2517.20,20130801
CGG_RS22-AU,2684,3740.15,115,270.60,2799,4010.75,20130801
CGG_RS23-AU,2037,2503.65,98,158.00,2135,2661.65,20130801
CGG_RS30-AU,1745,2576.30,73,167.40,1818,2743.70,20130801
CGG_RS31-AU,2058,2727.55,80,128.00,2138,2855.55,20130801
CGG_RS32-AU,1356,2305.50,74,220.60,1430,2526.10,20130801
CGG_RS33-AU,1490,1987.35,60,104.20,1550,2091.55,20130801
CGG_RS41-AU,1526,2559.70,108,274.20,1634,2833.90,20130801
CGG_RS42-AU,1613,3107.85,96,267.00,1709,3374.85,20130801
CGG_RS43-AU,877,1518.75,52,141.00,929,1659.75,20130801
CGG_RS44-AU,642,1281.75,32,89.80,674,1371.55,20130801
CGG_RS45-AU,1761,3106.40,97,269.80,1858,3376.20,20130801
CGG_RS46-AU,1009,2202.80,49,144.60,1058,2347.40,20130801
CGG_RS50-AU,538,933.55,31,59.00,569,992.55,20130801
CGG_RS53-AU,984,2214.85,65,204.20,1049,2419.05,20130801
CGG_RSX1-AU,281,556.05,17,58.00,298,614.05,20130801
CGG_RSX2-AU,673,1254.50,33,106.00,706,1360.50,20130801
CGG_RSX3-AU,443,1012.40,44,148.20,487,1160.60,20130801
CGG_RT12-AU,1254,3173.50,79,372.20,1333,3545.70,20130801
CGG_SS31-AU,722,1513.55,79,400.60,801,1914.15,20130801
CGG_SS32-AU,699,1388.25,45,193.60,744,1581.85,20130801
CGG_SW30-AU,489,1624.85,73,626.00,562,2250.85,20130801
CGG_SW31-AU,1313,3078.75,87,284.80,1400,3363.55,20130801
CGG_SW32-AU,434,1466.90,82,831.00,516,2297.90,20130801
CGG_SW33-AU,697,1788.40,55,189.60,752,1978.00,20130801
CGG_SW34-AU,738,2631.90,156,1586.00,894,4217.90,20130801
CGG_SW35-AU,733,1986.90,46,143.80,779,2130.70,20130801
CGG_TM10-AU,2405,5797.10,394,1444.90,2799,7242.00,20130801
CGG_TMX3-AU,1110,3637.70,230,1265.65,1340,4903.35,20130801
CGG_TMX4-AU,1949,6130.80,376,2076.00,2325,8206.80,20130801
CGG_TMX5-AU,1933,5730.00,444,2495.80,2377,8225.80,20130801
CGG_TMX6-AU,1857,5537.60,455,2728.30,2312,8265.90,20130801
CGG_TMX7-AU,1746,4363.65,319,1175.90,2065,5539.55,20130801
CGG_TMX8-AU,3080,7513.25,915,3464.05,3995,10977.30,20130801
CGG_TMX9-AU,3180,7626.25,577,2088.70,3757,9714.95,20130801
CGG_TPX1-AU,1385,2852.20,203,638.55,1588,3490.75,20130801
CGG_US10-AU,1306,1696.00,35,53.40,1341,1749.40,20130801
CGG_WES1-AU,475,1870.00,75,386.30,550,2256.30,20130801
CGG_WES2-AU,857,3064.35,132,700.05,989,3764.40,20130801
CGG_YA11-AU,902,1261.95,40,71.80,942,1333.75,20130801
CGG_YA13-AU,2353,3216.50,89,145.80,2442,3362.30,20130801
CGG_YA14-AU,1904,2626.05,85,138.20,1989,2764.25,20130801
CGG_YA15-AU,0,0.00,0,0.00,0,0.00,20130801
CGG_YA18-AU,1185,2056.60,56,134.00,1241,2190.60,20130801
CGG_YA20-AU,2002,2922.25,71,114.80,2073,3037.05,20130801
CGG_YA21-AU,1333,1786.00,36,53.80,1369,1839.80,20130801
CGG_YA23-AU,1058,1519.20,48,85.20,1106,1604.40,20130801
CGG_YA31-AU,1543,3262.95,76,208.60,1619,3471.55,20130801
CGG_YA32-AU,1125,2279.10,56,164.80,1181,2443.90,20130801
CGG_YA34-AU,917,1942.40,61,265.20,978,2207.60,20130801
CGG_YA35-AU,963,2420.45,64,254.20,1027,2674.65,20130801
CGG_YA36-AU,560,1253.30,54,251.00,614,1504.30,20130801
CGG_YAX1-AU,803,2069.15,71,290.20,874,2359.35,20130801
CGG_YAX2-AU,684,1656.80,42,162.60,726,1819.40,20130801
CGG_YAX3-AU,221,587.80,24,90.20,245,678.00,20130801
CGG_YAX4-AU,342,837.85,28,102.20,370,940.05,20130801
CGG_YCX1-AU,252,548.45,20,91.00,272,639.45,20130801
CGG_AP21-AU,599,1326.05,74,245.00,673,1571.05,20130901
CGG_BC21-AU,315,1306.05,146,1535.10,461,2841.15,20130901
CGG_BC41-AU,332,1150.10,148,713.20,480,1863.30,20130901
CGG_BC42-AU,145,527.35,58,280.60,203,807.95,20130901
CGG_BC43-AU,239,853.20,263,1308.00,502,2161.20,20130901
CGG_BR22-AU,405,833.70,57,184.60,462,1018.30,20130901
CGG_BR23-AU,840,1991.95,106,456.00,946,2447.95,20130901
CGG_BR26-AU,766,1529.70,59,187.00,825,1716.70,20130901
CGG_BR31-AU,612,1384.78,7,24.00,619,1408.78,20130901
CGG_BR32-AU,869,1658.35,52,145.40,921,1803.75,20130901
CGG_BR33-AU,399,920.60,39,179.00,438,1099.60,20130901
CGG_BR34-AU,1573,2774.00,70,197.00,1643,2971.00,20130901
CGG_BR35-AU,1026,2268.55,39,158.60,1065,2427.15,20130901
CGG_BR41-AU,207,753.50,36,174.00,243,927.50,20130901
CGG_BR42-AU,656,1516.25,98,345.00,754,1861.25,20130901
CGG_BR43-AU,75,261.10,107,532.00,182,793.10,20130901
CGG_BR44-AU,253,589.80,26,84.20,279,674.00,20130901
CGG_BR45-AU,80,339.60,95,473.00,175,812.60,20130901
CGG_BS11-AU,156,710.95,149,742.00,305,1452.95,20130901
CGG_BS12-AU,0,0.00,0,0.00,0,0.00,20130901
CGG_BS13-AU,162,712.40,125,624.00,287,1336.40,20130901
CGG_BS16-AU,136,599.05,52,257.00,188,856.05,20130901
CGG_BS17-AU,509,1335.50,54,403.00,563,1738.50,20130901
CGG_BS18-AU,570,1416.95,83,379.00,653,1795.95,20130901
CGG_BS21-AU,1173,2229.30,75,212.80,1248,2442.10,20130901
CGG_BS22-AU,553,879.20,30,77.60,583,956.80,20130901
CGG_BS23-AU,739,1431.35,32,99.60,771,1530.95,20130901
CGG_BS24-AU,1062,1906.10,52,157.00,1114,2063.10,20130901
CGG_BS25-AU,1456,2898.20,93,260.20,1549,3158.40,20130901
CGG_BS26-AU,1844,3655.10,114,308.60,1958,3963.70,20130901
CGG_BS27-AU,2204,4854.95,128,394.80,2332,5249.75,20130901
CGG_BS29-AU,995,2462.05,58,200.60,1053,2662.65,20130901
CGG_BS31-AU,895,2152.10,47,139.40,942,2291.50,20130901
CGG_BS32-AU,1230,2942.95,75,250.00,1305,3192.95,20130901
CGG_BS34-AU,150,351.30,5,15.00,155,366.30,20130901
CGG_BS35-AU,763,1812.00,43,145.00,806,1957.00,20130901
CGG_BS36-AU,2138,5172.20,119,390.60,2257,5562.80,20130901
CGG_BS37-AU,2012,4959.20,98,303.80,2110,5263.00,20130901
CGG_CCX1-AU,242,1348.90,180,2215.00,422,3563.90,20130901
CGG_CCX2-AU,289,1666.00,228,2410.50,517,4076.50,20130901
CGG_CCX3-AU,71,386.00,68,646.60,139,1032.60,20130901
CGG_CCX4-AU,93,483.85,76,748.30,169,1232.15,20130901
CGG_CCX5-AU,356,2670.85,257,2914.70,613,5585.55,20130901
CGG_CCX6-AU,89,686.40,102,1433.40,191,2119.80,20130901
CGG_CL11-AU,696,1414.75,102,326.60,798,1741.35,20130901
CGG_CLX2-AU,986,1928.50,51,146.00,1037,2074.50,20130901
CGG_CPX1-AU,1800,5149.40,205,864.00,2005,6013.40,20130901
CGG_CPX2-AU,993,2517.50,125,483.00,1118,3000.50,20130901
CGG_CS21-AU,791,2176.80,169,733.20,960,2910.00,20130901
CGG_CS22-AU,748,1504.20,59,166.20,807,1670.40,20130901
CGG_EB29-AU,485,1234.75,54,191.20,539,1425.95,20130901
CGG_EB31-AU,688,1673.70,58,208.80,746,1882.50,20130901
CGG_EB32-AU,893,2040.25,80,280.40,973,2320.65,20130901
CGG_EB33-AU,1613,3941.70,98,354.20,1711,4295.90,20130901
CGG_EB34-AU,1199,2463.50,65,215.60,1264,2679.10,20130901
CGG_EB35-AU,1286,3409.75,119,446.60,1405,3856.35,20130901
CGG_EB36-AU,1172,2931.95,79,283.20,1251,3215.15,20130901
CGG_EB41-AU,528,1640.05,75,416.00,603,2056.05,20130901
CGG_EB42-AU,172,708.30,108,534.00,280,1242.30,20130901
CGG_EB44-AU,102,435.85,142,707.00,244,1142.85,20130901
CGG_EB46-AU,50,221.25,46,229.00,96,450.25,20130901
CGG_FM21-AU,506,2028.50,177,1726.85,683,3755.35,20130901
CGG_FM22-AU,374,1782.05,212,2268.35,586,4050.40,20130901
CGG_FM23-AU,342,1373.85,264,2856.95,606,4230.80,20130901
CGG_FM24-AU,270,1150.55,232,2573.30,502,3723.85,20130901
CGG_FS21-AU,282,1100.45,102,981.45,384,2081.90,20130901
CGG_FS22-AU,279,759.15,54,251.60,333,1010.75,20130901
CGG_FS23-AU,130,627.20,81,1022.60,211,1649.80,20130901
CGG_FS24-AU,301,913.85,63,309.60,364,1223.45,20130901
CGG_FS25-AU,322,979.20,46,244.00,368,1223.20,20130901
CGG_FS26-AU,321,1008.50,72,369.20,393,1377.70,20130901
CGG_FS31-AU,796,1552.25,40,123.60,836,1675.85,20130901
CGG_FS32-AU,864,1768.00,68,213.20,932,1981.20,20130901
CGG_FS33-AU,1572,2524.30,66,188.60,1638,2712.90,20130901
CGG_GC13-AU,221,809.60,124,604.00,345,1413.60,20130901
CGG_GH15-AU,280,682.85,31,107.60,311,790.45,20130901
CGG_GH21-AU,485,882.65,23,72.00,508,954.65,20130901
CGG_GH23-AU,1063,1728.55,85,202.20,1148,1930.75,20130901
CGG_GH24-AU,1983,2621.30,108,165.60,2091,2786.90,20130901
CGG_GH31-AU,1400,1730.75,64,112.20,1464,1842.95,20130901
CGG_GH32-AU,1088,1419.70,39,70.60,1127,1490.30,20130901
CGG_GH33-AU,767,1580.75,50,182.60,817,1763.35,20130901
CGG_GH34-AU,904,1865.45,84,268.60,988,2134.05,20130901
CGG_GH36-AU,1209,2452.55,39,108.20,1248,2560.75,20130901
CGG_GHX1-AU,1019,2975.75,238,1074.00,1257,4049.75,20130901
CGG_GHX3-AU,1264,3766.45,264,1261.20,1528,5027.65,20130901
CGG_GHX5-AU,0,0.00,0,0.00,0,0.00,20130901
CGG_GM11-AU,193,541.15,34,117.60,227,658.75,20130901
CGG_GM16-AU,214,536.10,35,115.00,249,651.10,20130901
CGG_HAY1-AU,381,2206.60,563,4086.75,944,6293.35,20130901
CGG_HAY2-AU,510,2959.90,509,3691.05,1019,6650.95,20130901
CGG_HAY3-AU,1436,7100.10,1177,8478.50,2613,15578.60,20130901
CGG_JSX1-AU,1174,2486.70,126,386.20,1300,2872.90,20130901
CGG_JSX2-AU,1453,2138.20,95,165.40,1548,2303.60,20130901
CGG_LM11-AU,960,1875.05,69,218.20,1029,2093.25,20130901
CGG_LM12-AU,1045,1882.80,84,261.80,1129,2144.60,20130901
CGG_LM13-AU,843,1402.40,46,137.20,889,1539.60,20130901
CGG_LM14-AU,0,0.00,0,0.00,0,0.00,20130901
CGG_LM15-AU,628,1338.40,48,149.60,676,1488.00,20130901
CGG_LM16-AU,806,1685.40,101,341.80,907,2027.20,20130901
CGG_LM30-AU,1309,1612.70,39,65.80,1348,1678.50,20130901
CGG_LM32-AU,2373,2985.25,86,126.40,2459,3111.65,20130901
CGG_LM41-AU,1060,1723.40,64,177.80,1124,1901.20,20130901
CGG_LM42-AU,1032,1579.40,45,118.60,1077,1698.00,20130901
CGG_LM43-AU,1602,1737.25,59,113.00,1661,1850.25,20130901
CGG_LM44-AU,2038,2735.15,66,147.00,2104,2882.15,20130901
CGG_LMX2-AU,309,1578.30,153,1546.50,462,3124.80,20130901
CGG_LR11-AU,688,1275.20,42,120.60,730,1395.80,20130901
CGG_LR12-AU,1048,1792.60,55,142.00,1103,1934.60,20130901
CGG_LR13-AU,1683,3149.65,95,265.80,1778,3415.45,20130901
CGG_LR14-AU,816,1465.25,38,100.20,854,1565.45,20130901
CGG_LR15-AU,149,569.25,106,520.00,255,1089.25,20130901
CGG_LR16-AU,783,1601.30,110,354.80,893,1956.10,20130901
CGG_LR31-AU,306,835.25,59,278.60,365,1113.85,20130901
CGG_LR33-AU,527,1325.40,44,194.20,571,1519.60,20130901
CGG_LR43-AU,826,1967.45,39,139.60,865,2107.05,20130901
CGG_LR47-AU,1308,3365.00,100,389.60,1408,3754.60,20130901
CGG_MB11-AU,932,1725.00,49,135.80,981,1860.80,20130901
CGG_MB12-AU,1298,2476.45,85,234.00,1383,2710.45,20130901
CGG_MB13-AU,809,1512.70,45,122.00,854,1634.70,20130901
CGG_MB14-AU,1146,1558.85,12,24.00,1158,1582.85,20130901
CGG_MB15-AU,746,982.50,40,63.20,786,1045.70,20130901
CGG_MB16-AU,1000,1307.75,51,77.80,1051,1385.55,20130901
CGG_MB17-AU,1696,2128.45,39,65.00,1735,2193.45,20130901
CGG_MB23-AU,1798,2225.20,47,68.40,1845,2293.60,20130901
CGG_MB31-AU,2165,3013.10,90,237.40,2255,3250.50,20130901
CGG_MB32-AU,1939,2299.55,42,59.00,1981,2358.55,20130901
CGG_MB33-AU,1823,2616.70,80,191.60,1903,2808.30,20130901
CGG_MB34-AU,1762,1921.45,40,61.40,1802,1982.85,20130901
CGG_MB35-AU,1126,1735.65,49,122.20,1175,1857.85,20130901
CGG_MB36-AU,2526,2684.80,73,101.40,2599,2786.20,20130901
CGG_MB37-AU,864,1344.90,28,78.60,892,1423.50,20130901
CGG_MB38-AU,2016,2457.55,54,87.40,2070,2544.95,20130901
CGG_MB41-AU,1775,2835.10,76,194.40,1851,3029.50,20130901
CGG_MB42-AU,1046,2225.20,42,114.40,1088,2339.60,20130901
CGG_MB44-AU,1502,3120.65,63,187.60,1565,3308.25,20130901
CGG_MBX1-AU,1269,2902.45,91,276.60,1360,3179.05,20130901
CGG_MBX2-AU,1096,2505.15,84,246.00,1180,2751.15,20130901
CGG_MBX4-AU,810,1690.55,49,142.60,859,1833.15,20130901
CGG_MC21-AU,1037,2757.55,133,973.05,1170,3730.60,20130901
CGG_MC22-AU,676,1523.35,75,597.55,751,2120.90,20130901
CGG_MC23-AU,1056,2700.20,98,693.75,1154,3393.95,20130901
CGG_MK31-AU,259,778.80,25,122.00,284,900.80,20130901
CGG_MK34-AU,218,644.00,45,182.60,263,826.60,20130901
CGG_MK35-AU,112,293.40,11,55.00,123,348.40,20130901
CGG_MM41-AU,2089,3159.05,73,144.80,2162,3303.85,20130901
CGG_MS10-AU,559,700.05,27,44.40,586,744.45,20130901
CGG_MS11-AU,1138,1995.65,68,194.80,1206,2190.45,20130901
CGG_MS12-AU,2020,2380.05,77,124.00,2097,2504.05,20130901
CGG_MS21-AU,1855,2344.45,81,130.60,1936,2475.05,20130901
CGG_MS30-AU,805,1004.90,31,50.40,836,1055.30,20130901
CGG_MS31-AU,2893,4033.55,150,260.60,3043,4294.15,20130901
CGG_MS32-AU,1534,2091.95,86,144.40,1620,2236.35,20130901
CGG_MS41-AU,1229,1536.50,32,55.20,1261,1591.70,20130901
CGG_MS42-AU,2117,2222.85,105,142.20,2222,2365.05,20130901
CGG_MS43-AU,1967,2856.65,64,147.20,2031,3003.85,20130901
CGG_MS44-AU,1630,2198.95,68,110.20,1698,2309.15,20130901
CGG_MS46-AU,1475,1795.65,30,48.00,1505,1843.65,20130901
CGG_MY21-AU,929,1631.25,34,80.20,963,1711.45,20130901
CGG_MY22-AU,550,1190.85,25,68.20,575,1259.05,20130901
CGG_MY23-AU,773,1458.05,37,116.00,810,1574.05,20130901
CGG_MY24-AU,0,0.00,0,0.00,0,0.00,20130901
CGG_MY25-AU,1204,2343.70,70,214.60,1274,2558.30,20130901
CGG_MY31-AU,558,1156.55,61,203.20,619,1359.75,20130901
CGG_MY32-AU,705,1523.60,57,173.00,762,1696.60,20130901
CGG_MY33-AU,376,844.50,32,107.60,408,952.10,20130901
CGG_MY34-AU,576,1336.35,25,77.20,601,1413.55,20130901
CGG_MY35-AU,359,826.00,37,121.20,396,947.20,20130901
CGG_MY41-AU,1860,3421.30,100,262.20,1960,3683.50,20130901
CGG_MY42-AU,2633,4269.40,112,273.20,2745,4542.60,20130901
CGG_MY43-AU,933,2210.85,52,150.20,985,2361.05,20130901
CGG_MY44-AU,523,1284.55,28,86.60,551,1371.15,20130901
CGG_MY45-AU,846,2199.65,66,221.00,912,2420.65,20130901
CGG_MY46-AU,1803,4801.95,111,350.80,1914,5152.75,20130901
CGG_MY47-AU,1286,3322.70,88,282.60,1374,3605.30,20130901
CGG_MY51-AU,1165,3433.55,99,414.20,1264,3847.75,20130901
CGG_MY52-AU,1196,3846.15,203,1214.80,1399,5060.95,20130901
CGG_MY53-AU,708,2195.20,78,374.20,786,2569.40,20130901
CGG_MY54-AU,1032,3515.25,158,926.60,1190,4441.85,20130901
CGG_MY55-AU,1235,3713.40,91,375.40,1326,4088.80,20130901
CGG_MY56-AU,1147,4139.00,168,1050.40,1315,5189.40,20130901
CGG_MY57-AU,1119,3506.10,107,463.20,1226,3969.30,20130901
CGG_PNR1-AU,897,2702.50,290,870.00,1187,3572.50,20130901
CGG_PNR2-AU,112,339.05,10,30.00,122,369.05,20130901
CGG_RBX4-AU,0,0.00,0,0.00,0,0.00,20130901
CGG_RBX5-AU,312,1039.90,74,287.00,386,1326.90,20130901
CGG_RBX6-AU,400,1529.90,230,913.00,630,2442.90,20130901
CGG_RBX7-AU,307,1156.90,147,584.00,454,1740.90,20130901
CGG_RS11-AU,801,911.45,30,45.40,831,956.85,20130901
CGG_RS13-AU,663,771.50,39,61.80,702,833.30,20130901
CGG_RS14-AU,1641,1939.25,60,153.80,1701,2093.05,20130901
CGG_RS15-AU,907,1196.90,40,78.00,947,1274.90,20130901
CGG_RS16-AU,1531,2216.25,90,253.60,1621,2469.85,20130901
CGG_RS20-AU,1463,2039.55,79,178.20,1542,2217.75,20130901
CGG_RS21-AU,1705,2171.30,64,102.40,1769,2273.70,20130901
CGG_RS22-AU,2377,3364.45,78,199.00,2455,3563.45,20130901
CGG_RS23-AU,1796,2185.15,79,124.40,1875,2309.55,20130901
CGG_RS30-AU,1576,2438.35,98,253.00,1674,2691.35,20130901
CGG_RS31-AU,1982,2630.70,68,108.40,2050,2739.10,20130901
CGG_RS32-AU,1193,2203.20,99,314.60,1292,2517.80,20130901
CGG_RS33-AU,1389,1817.85,49,86.80,1438,1904.65,20130901
CGG_RS41-AU,1390,2309.40,99,255.40,1489,2564.80,20130901
CGG_RS42-AU,1453,2807.00,99,285.20,1552,3092.20,20130901
CGG_RS43-AU,775,1327.00,49,122.20,824,1449.20,20130901
CGG_RS44-AU,577,1121.15,25,71.60,602,1192.75,20130901
CGG_RS45-AU,1582,2766.20,91,239.80,1673,3006.00,20130901
CGG_RS46-AU,839,1732.00,61,191.80,900,1923.80,20130901
CGG_RS50-AU,439,750.90,25,46.60,464,797.50,20130901
CGG_RS53-AU,875,1895.55,75,224.00,950,2119.55,20130901
CGG_RSX1-AU,209,405.75,7,18.60,216,424.35,20130901
CGG_RSX2-AU,549,1041.40,34,97.40,583,1138.80,20130901
CGG_RSX3-AU,441,965.45,35,128.00,476,1093.45,20130901
CGG_RT12-AU,1148,2930.05,98,433.00,1246,3363.05,20130901
CGG_SS31-AU,667,1327.90,47,219.60,714,1547.50,20130901
CGG_SS32-AU,465,898.20,21,71.20,486,969.40,20130901
CGG_SW30-AU,392,1196.35,71,586.00,463,1782.35,20130901
CGG_SW31-AU,1194,2857.60,93,268.40,1287,3126.00,20130901
CGG_SW32-AU,398,1405.10,69,685.00,467,2090.10,20130901
CGG_SW33-AU,601,1484.70,51,155.60,652,1640.30,20130901
CGG_SW34-AU,631,2292.85,146,1341.00,777,3633.85,20130901
CGG_SW35-AU,580,1520.45,52,152.40,632,1672.85,20130901
CGG_TM10-AU,2095,4926.40,421,1574.55,2516,6500.95,20130901
CGG_TMX3-AU,1256,4023.20,233,1307.80,1489,5331.00,20130901
CGG_TMX4-AU,1381,4340.10,279,1538.90,1660,5879.00,20130901
CGG_TMX5-AU,1725,4807.50,389,2225.15,2114,7032.65,20130901
CGG_TMX6-AU,1713,5365.10,388,2266.95,2101,7632.05,20130901
CGG_TMX7-AU,1407,3534.65,316,1187.35,1723,4722.00,20130901
CGG_TMX8-AU,2520,6459.95,858,3288.60,3378,9748.55,20130901
CGG_TMX9-AU,2657,6168.80,393,1411.65,3050,7580.45,20130901
CGG_TPX1-AU,1130,2353.05,176,566.80,1306,2919.85,20130901
CGG_US10-AU,1259,1691.05,37,60.00,1296,1751.05,20130901
CGG_WES1-AU,427,1636.40,100,589.00,527,2225.40,20130901
CGG_WES2-AU,773,2813.30,166,902.15,939,3715.45,20130901
CGG_YA11-AU,881,1202.25,34,53.60,915,1255.85,20130901
CGG_YA13-AU,2266,3039.20,75,121.80,2341,3161.00,20130901
CGG_YA14-AU,1677,2323.00,79,128.80,1756,2451.80,20130901
CGG_YA15-AU,0,0.00,0,0.00,0,0.00,20130901
CGG_YA18-AU,1124,2018.20,45,111.80,1169,2130.00,20130901
CGG_YA20-AU,1964,2856.00,73,117.80,2037,2973.80,20130901
CGG_YA21-AU,1242,1662.35,43,73.80,1285,1736.15,20130901
CGG_YA23-AU,907,1311.95,35,62.20,942,1374.15,20130901
CGG_YA31-AU,1460,3033.95,81,239.40,1541,3273.35,20130901
CGG_YA32-AU,1069,2120.55,55,185.20,1124,2305.75,20130901
CGG_YA34-AU,881,1943.80,50,221.00,931,2164.80,20130901
CGG_YA35-AU,1000,2459.60,64,271.60,1064,2731.20,20130901
CGG_YA36-AU,618,1393.80,46,196.60,664,1590.40,20130901
CGG_YAX1-AU,857,2274.40,76,272.80,933,2547.20,20130901
CGG_YAX2-AU,741,1799.90,70,239.20,811,2039.10,20130901
CGG_YAX3-AU,282,755.95,22,80.00,304,835.95,20130901
CGG_YAX4-AU,406,982.30,39,167.60,445,1149.90,20130901
CGG_YCX1-AU,284,660.00,33,144.00,317,804.00,20130901
CGG_AP21-AU,513,1202.40,57,171.80,570,1374.20,20131001
CGG_BC21-AU,279,1106.45,180,2046.90,459,3153.35,20131001
CGG_BC41-AU,353,1253.40,163,788.60,516,2042.00,20131001
CGG_BC42-AU,112,436.75,54,270.00,166,706.75,20131001
CGG_BC43-AU,232,916.80,252,1232.60,484,2149.40,20131001
CGG_BR22-AU,527,1118.10,69,234.60,596,1352.70,20131001
CGG_BR23-AU,871,2204.75,119,527.00,990,2731.75,20131001
CGG_BR26-AU,918,1889.70,85,249.40,1003,2139.10,20131001
CGG_BR31-AU,885,2002.30,15,69.00,900,2071.30,20131001
CGG_BR32-AU,945,1792.80,53,144.40,998,1937.20,20131001
CGG_BR33-AU,383,874.30,71,330.20,454,1204.50,20131001
CGG_BR34-AU,1687,3064.00,84,214.60,1771,3278.60,20131001
CGG_BR35-AU,1019,2508.10,68,290.20,1087,2798.30,20131001
CGG_BR41-AU,155,577.10,48,240.00,203,817.10,20131001
CGG_BR42-AU,668,1515.65,104,372.00,772,1887.65,20131001
CGG_BR43-AU,106,393.90,107,535.00,213,928.90,20131001
CGG_BR44-AU,165,409.90,15,48.60,180,458.50,20131001
CGG_BR45-AU,86,363.90,105,518.00,191,881.90,20131001
CGG_BS11-AU,206,891.40,146,723.00,352,1614.40,20131001
CGG_BS12-AU,0,0.00,0,0.00,0,0.00,20131001
CGG_BS13-AU,214,906.55,146,721.00,360,1627.55,20131001
CGG_BS16-AU,179,716.60,84,415.00,263,1131.60,20131001
CGG_BS17-AU,587,1585.85,71,521.00,658,2106.85,20131001
CGG_BS18-AU,561,1312.70,79,324.00,640,1636.70,20131001
CGG_BS21-AU,1455,2774.45,68,204.60,1523,2979.05,20131001
CGG_BS22-AU,1025,1689.20,42,112.20,1067,1801.40,20131001
CGG_BS23-AU,978,1945.70,62,156.40,1040,2102.10,20131001
CGG_BS24-AU,1220,2138.40,64,172.40,1284,2310.80,20131001
CGG_BS25-AU,1569,3179.65,104,306.40,1673,3486.05,20131001
CGG_BS26-AU,2137,4335.20,120,322.40,2257,4657.60,20131001
CGG_BS27-AU,2495,5455.85,138,410.00,2633,5865.85,20131001
CGG_BS29-AU,985,2443.15,47,154.00,1032,2597.15,20131001
CGG_BS31-AU,963,2325.65,58,179.20,1021,2504.85,20131001
CGG_BS32-AU,1257,2945.90,60,178.60,1317,3124.50,20131001
CGG_BS34-AU,128,303.25,1,4.00,129,307.25,20131001
CGG_BS35-AU,854,2035.00,46,141.60,900,2176.60,20131001
CGG_BS36-AU,2190,5217.00,126,410.80,2316,5627.80,20131001
CGG_BS37-AU,2090,5180.30,113,362.40,2203,5542.70,20131001
CGG_CCX1-AU,226,1237.95,210,2546.10,436,3784.05,20131001
CGG_CCX2-AU,297,1710.40,225,2391.80,522,4102.20,20131001
CGG_CCX3-AU,84,409.05,67,646.80,151,1055.85,20131001
CGG_CCX4-AU,65,329.05,55,525.40,120,854.45,20131001
CGG_CCX5-AU,398,3037.40,198,2347.50,596,5384.90,20131001
CGG_CCX6-AU,86,631.00,129,1918.30,215,2549.30,20131001
CGG_CL11-AU,788,1645.30,94,292.60,882,1937.90,20131001
CGG_CLX2-AU,973,2027.70,51,156.00,1024,2183.70,20131001
CGG_CPX1-AU,2015,5921.85,233,997.40,2248,6919.25,20131001
CGG_CPX2-AU,950,2507.50,143,575.40,1093,3082.90,20131001
CGG_CS21-AU,932,2514.90,200,909.60,1132,3424.50,20131001
CGG_CS22-AU,715,1434.90,88,262.40,803,1697.30,20131001
CGG_EB29-AU,547,1463.15,58,229.00,605,1692.15,20131001
CGG_EB31-AU,743,1878.15,63,255.00,806,2133.15,20131001
CGG_EB32-AU,946,2312.30,79,308.00,1025,2620.30,20131001
CGG_EB33-AU,1761,4300.15,95,379.00,1856,4679.15,20131001
CGG_EB34-AU,1175,2478.20,60,181.20,1235,2659.40,20131001
CGG_EB35-AU,1409,3759.75,147,574.20,1556,4333.95,20131001
CGG_EB36-AU,1252,3257.85,130,508.40,1382,3766.25,20131001
CGG_EB41-AU,631,2020.25,82,545.00,713,2565.25,20131001
CGG_EB42-AU,253,966.75,142,698.00,395,1664.75,20131001
CGG_EB44-AU,135,526.05,174,863.00,309,1389.05,20131001
CGG_EB46-AU,0,0.00,0,0.00,0,0.00,20131001
CGG_FM21-AU,451,1685.25,205,2133.45,656,3818.70,20131001
CGG_FM22-AU,336,1540.70,234,2585.50,570,4126.20,20131001
CGG_FM23-AU,389,1569.40,268,2959.20,657,4528.60,20131001
CGG_FM24-AU,278,1173.40,230,2622.10,508,3795.50,20131001
CGG_FS21-AU,265,995.65,115,1111.20,380,2106.85,20131001
CGG_FS22-AU,286,787.45,77,393.00,363,1180.45,20131001
CGG_FS23-AU,159,658.15,123,1500.85,282,2159.00,20131001
CGG_FS24-AU,346,899.30,61,312.60,407,1211.90,20131001
CGG_FS25-AU,316,906.50,87,441.60,403,1348.10,20131001
CGG_FS26-AU,337,1017.40,75,378.00,412,1395.40,20131001
CGG_FS31-AU,816,1480.50,62,176.60,878,1657.10,20131001
CGG_FS32-AU,975,1933.20,86,279.20,1061,2212.40,20131001
CGG_FS33-AU,1653,2787.65,70,208.00,1723,2995.65,20131001
CGG_GC13-AU,249,915.50,145,707.00,394,1622.50,20131001
CGG_GH15-AU,298,682.30,43,146.60,341,828.90,20131001
CGG_GH21-AU,501,918.90,29,85.60,530,1004.50,20131001
CGG_GH23-AU,1138,1968.90,102,250.20,1240,2219.10,20131001
CGG_GH24-AU,2108,2807.95,117,184.40,2225,2992.35,20131001
CGG_GH31-AU,1553,1959.25,71,129.80,1624,2089.05,20131001
CGG_GH32-AU,1328,1748.95,62,104.00,1390,1852.95,20131001
CGG_GH33-AU,894,2118.25,110,454.00,1004,2572.25,20131001
CGG_GH34-AU,952,2010.90,96,309.00,1048,2319.90,20131001
CGG_GH36-AU,1307,2607.45,42,126.20,1349,2733.65,20131001
CGG_GHX1-AU,1030,2818.70,165,727.40,1195,3546.10,20131001
CGG_GHX3-AU,902,2540.85,172,786.20,1074,3327.05,20131001
CGG_GHX5-AU,358,915.05,63,295.80,421,1210.85,20131001
CGG_GM11-AU,186,521.00,45,159.20,231,680.20,20131001
CGG_GM16-AU,195,483.20,45,162.00,240,645.20,20131001
CGG_HAY1-AU,344,2123.10,524,3826.90,868,5950.00,20131001
CGG_HAY2-AU,585,3341.80,597,4338.25,1182,7680.05,20131001
CGG_HAY3-AU,1527,7610.50,1203,8727.80,2730,16338.30,20131001
CGG_JSX1-AU,1195,2517.40,146,477.00,1341,2994.40,20131001
CGG_JSX2-AU,1689,2484.50,91,160.80,1780,2645.30,20131001
CGG_LM11-AU,961,1738.75,75,241.80,1036,1980.55,20131001
CGG_LM12-AU,1015,1769.80,68,214.20,1083,1984.00,20131001
CGG_LM13-AU,754,1267.80,59,172.00,813,1439.80,20131001
CGG_LM14-AU,189,335.21,0,0.00,189,335.21,20131001
CGG_LM15-AU,571,1135.20,53,165.60,624,1300.80,20131001
CGG_LM16-AU,924,1936.15,78,259.20,1002,2195.35,20131001
CGG_LM30-AU,1339,1719.25,64,98.40,1403,1817.65,20131001
CGG_LM32-AU,2335,3082.05,99,143.00,2434,3225.05,20131001
CGG_LM41-AU,1195,1966.00,49,125.80,1244,2091.80,20131001
CGG_LM42-AU,1054,1587.80,51,123.60,1105,1711.40,20131001
CGG_LM43-AU,1980,2148.65,54,112.80,2034,2261.45,20131001
CGG_LM44-AU,1985,2537.35,86,214.20,2071,2751.55,20131001
CGG_LMX2-AU,290,1495.05,178,1853.00,468,3348.05,20131001
CGG_LR11-AU,726,1348.40,57,166.20,783,1514.60,20131001
CGG_LR12-AU,1228,2144.35,54,151.80,1282,2296.15,20131001
CGG_LR13-AU,1954,3515.75,108,289.40,2062,3805.15,20131001
CGG_LR14-AU,917,1624.80,38,114.20,955,1739.00,20131001
CGG_LR15-AU,210,736.95,88,423.00,298,1159.95,20131001
CGG_LR16-AU,883,1721.20,127,397.80,1010,2119.00,20131001
CGG_LR31-AU,370,961.00,69,303.80,439,1264.80,20131001
CGG_LR33-AU,597,1547.80,61,264.80,658,1812.60,20131001
CGG_LR43-AU,816,1922.50,46,167.20,862,2089.70,20131001
CGG_LR47-AU,1197,3171.55,104,422.60,1301,3594.15,20131001
CGG_MB11-AU,949,1785.00,45,124.80,994,1909.80,20131001
CGG_MB12-AU,1445,2760.05,75,208.20,1520,2968.25,20131001
CGG_MB13-AU,909,1676.25,35,93.40,944,1769.65,20131001
CGG_MB14-AU,1152,1568.20,13,20.20,1165,1588.40,20131001
CGG_MB15-AU,831,1095.05,43,68.80,874,1163.85,20131001
CGG_MB16-AU,1075,1426.70,67,114.00,1142,1540.70,20131001
CGG_MB17-AU,1651,2121.70,61,93.40,1712,2215.10,20131001
CGG_MB23-AU,1887,2307.75,59,90.20,1946,2397.95,20131001
CGG_MB31-AU,2314,3262.05,102,221.80,2416,3483.85,20131001
CGG_MB32-AU,2377,2672.75,63,86.80,2440,2759.55,20131001
CGG_MB33-AU,2051,3027.75,82,191.80,2133,3219.55,20131001
CGG_MB34-AU,1999,2142.65,50,74.00,2049,2216.65,20131001
CGG_MB35-AU,1294,1987.85,58,148.60,1352,2136.45,20131001
CGG_MB36-AU,2802,3041.45,99,150.00,2901,3191.45,20131001
CGG_MB37-AU,1011,1483.15,37,95.40,1048,1578.55,20131001
CGG_MB38-AU,2166,2735.10,43,66.20,2209,2801.30,20131001
CGG_MB41-AU,1855,3000.00,76,214.00,1931,3214.00,20131001
CGG_MB42-AU,1183,2403.00,51,159.00,1234,2562.00,20131001
CGG_MB44-AU,1540,3162.10,79,244.20,1619,3406.30,20131001
CGG_MBX1-AU,1480,3451.35,89,279.20,1569,3730.55,20131001
CGG_MBX2-AU,1297,2960.35,130,404.20,1427,3364.55,20131001
CGG_MBX4-AU,908,1957.00,65,201.60,973,2158.60,20131001
CGG_MC21-AU,1074,2717.80,117,844.55,1191,3562.35,20131001
CGG_MC22-AU,738,1919.45,95,664.90,833,2584.35,20131001
CGG_MC23-AU,1044,2431.85,103,700.40,1147,3132.25,20131001
CGG_MK31-AU,275,796.75,34,155.20,309,951.95,20131001
CGG_MK34-AU,203,596.00,49,209.00,252,805.00,20131001
CGG_MK35-AU,153,395.75,28,121.00,181,516.75,20131001
CGG_MM41-AU,2289,3497.70,91,203.00,2380,3700.70,20131001
CGG_MS10-AU,605,746.65,29,54.00,634,800.65,20131001
CGG_MS11-AU,1253,2262.50,79,227.40,1332,2489.90,20131001
CGG_MS12-AU,2202,2577.30,77,117.20,2279,2694.50,20131001
CGG_MS21-AU,1996,2617.15,83,135.40,2079,2752.55,20131001
CGG_MS30-AU,864,1124.05,52,85.60,916,1209.65,20131001
CGG_MS31-AU,2832,4019.45,88,148.80,2920,4168.25,20131001
CGG_MS32-AU,1786,2450.85,91,142.60,1877,2593.45,20131001
CGG_MS41-AU,1337,1695.25,46,66.40,1383,1761.65,20131001
CGG_MS42-AU,2154,2334.75,73,94.60,2227,2429.35,20131001
CGG_MS43-AU,2165,3175.85,77,172.80,2242,3348.65,20131001
CGG_MS44-AU,1809,2371.80,73,148.00,1882,2519.80,20131001
CGG_MS46-AU,1506,1934.90,40,70.60,1546,2005.50,20131001
CGG_MY21-AU,994,1703.40,42,110.00,1036,1813.40,20131001
CGG_MY22-AU,489,1040.90,42,145.00,531,1185.90,20131001
CGG_MY23-AU,932,1732.05,30,75.80,962,1807.85,20131001
CGG_MY24-AU,0,0.00,0,0.00,0,0.00,20131001
CGG_MY25-AU,1334,2567.55,35,105.00,1369,2672.55,20131001
CGG_MY31-AU,575,1182.80,88,274.20,663,1457.00,20131001
CGG_MY32-AU,721,1515.70,57,182.00,778,1697.70,20131001
CGG_MY33-AU,367,818.85,38,132.60,405,951.45,20131001
CGG_MY34-AU,484,1240.70,33,104.00,517,1344.70,20131001
CGG_MY35-AU,351,825.80,41,136.80,392,962.60,20131001
CGG_MY41-AU,1662,3013.70,77,208.80,1739,3222.50,20131001
CGG_MY42-AU,2632,4439.75,127,324.20,2759,4763.95,20131001
CGG_MY43-AU,1032,2507.15,41,120.60,1073,2627.75,20131001
CGG_MY44-AU,468,1164.05,25,76.00,493,1240.05,20131001
CGG_MY45-AU,935,2446.60,67,220.20,1002,2666.80,20131001
CGG_MY46-AU,1859,4906.75,106,351.60,1965,5258.35,20131001
CGG_MY47-AU,1420,3572.20,97,306.80,1517,3879.00,20131001
CGG_MY51-AU,1209,3541.10,117,486.60,1326,4027.70,20131001
CGG_MY52-AU,1284,4185.05,211,1298.00,1495,5483.05,20131001
CGG_MY53-AU,501,1501.80,53,269.00,554,1770.80,20131001
CGG_MY54-AU,885,2974.65,137,792.80,1022,3767.45,20131001
CGG_MY55-AU,1160,3519.80,136,617.80,1296,4137.60,20131001
CGG_MY56-AU,1238,4462.40,180,1040.80,1418,5503.20,20131001
CGG_MY57-AU,1187,3636.45,127,596.00,1314,4232.45,20131001
CGG_PNR1-AU,864,2601.70,265,795.00,1129,3396.70,20131001
CGG_PNR2-AU,111,333.80,8,24.00,119,357.80,20131001
CGG_RBX4-AU,164,459.65,22,83.00,186,542.65,20131001
CGG_RBX5-AU,337,1285.75,95,368.00,432,1653.75,20131001
CGG_RBX6-AU,462,1770.10,219,871.00,681,2641.10,20131001
CGG_RBX7-AU,384,1409.80,130,507.00,514,1916.80,20131001
CGG_RS11-AU,658,743.70,25,39.60,683,783.30,20131001
CGG_RS13-AU,592,655.90,22,33.40,614,689.30,20131001
CGG_RS14-AU,1648,1768.45,57,144.20,1705,1912.65,20131001
CGG_RS15-AU,882,1168.90,48,87.80,930,1256.70,20131001
CGG_RS16-AU,1591,2212.15,84,228.40,1675,2440.55,20131001
CGG_RS20-AU,1555,2195.20,95,278.00,1650,2473.20,20131001
CGG_RS21-AU,1833,2319.55,72,109.80,1905,2429.35,20131001
CGG_RS22-AU,2785,3819.40,107,254.80,2892,4074.20,20131001
CGG_RS23-AU,1984,2457.55,91,144.40,2075,2601.95,20131001
CGG_RS30-AU,1726,2624.80,70,184.20,1796,2809.00,20131001
CGG_RS31-AU,2099,2855.20,66,107.80,2165,2963.00,20131001
CGG_RS32-AU,1275,2200.00,133,447.40,1408,2647.40,20131001
CGG_RS33-AU,1494,2007.80,52,80.40,1546,2088.20,20131001
CGG_RS41-AU,1487,2580.10,94,244.80,1581,2824.90,20131001
CGG_RS42-AU,1463,2731.00,88,256.00,1551,2987.00,20131001
CGG_RS43-AU,781,1383.90,53,134.80,834,1518.70,20131001
CGG_RS44-AU,598,1175.05,38,112.60,636,1287.65,20131001
CGG_RS45-AU,1684,2876.80,120,303.20,1804,3180.00,20131001
CGG_RS46-AU,1005,2087.35,62,169.40,1067,2256.75,20131001
CGG_RS50-AU,500,844.95,23,44.00,523,888.95,20131001
CGG_RS53-AU,913,2081.45,74,229.00,987,2310.45,20131001
CGG_RSX1-AU,275,522.20,7,23.60,282,545.80,20131001
CGG_RSX2-AU,681,1190.85,31,72.20,712,1263.05,20131001
CGG_RSX3-AU,489,1036.35,38,133.00,527,1169.35,20131001
CGG_RT12-AU,1241,2987.70,89,394.40,1330,3382.10,20131001
CGG_SS31-AU,738,1484.00,45,172.00,783,1656.00,20131001
CGG_SS32-AU,644,1228.10,31,116.20,675,1344.30,20131001
CGG_SW30-AU,398,1234.40,85,697.00,483,1931.40,20131001
CGG_SW31-AU,1333,3193.95,88,288.80,1421,3482.75,20131001
CGG_SW32-AU,439,1402.15,89,825.00,528,2227.15,20131001
CGG_SW33-AU,576,1482.20,50,167.60,626,1649.80,20131001
CGG_SW34-AU,675,2354.95,164,1459.00,839,3813.95,20131001
CGG_SW35-AU,650,1700.20,38,135.60,688,1835.80,20131001
CGG_TM10-AU,2525,5833.75,421,1537.05,2946,7370.80,20131001
CGG_TMX3-AU,1159,3704.90,212,1219.45,1371,4924.35,20131001
CGG_TMX4-AU,1890,6014.60,288,1497.10,2178,7511.70,20131001
CGG_TMX5-AU,1868,5568.00,495,2909.80,2363,8477.80,20131001
CGG_TMX6-AU,1748,5413.25,462,2726.05,2210,8139.30,20131001
CGG_TMX7-AU,1631,4087.15,346,1312.70,1977,5399.85,20131001
CGG_TMX8-AU,2931,7266.55,909,3417.80,3840,10684.35,20131001
CGG_TMX9-AU,2565,5992.75,495,1765.65,3060,7758.40,20131001
CGG_TPX1-AU,1140,2267.90,183,564.10,1323,2832.00,20131001
CGG_US10-AU,1346,1843.15,48,81.00,1394,1924.15,20131001
CGG_WES1-AU,502,1911.20,72,361.95,574,2273.15,20131001
CGG_WES2-AU,849,2890.05,179,930.30,1028,3820.35,20131001
CGG_YA11-AU,984,1363.50,33,52.40,1017,1415.90,20131001
CGG_YA13-AU,2171,2985.00,76,123.20,2247,3108.20,20131001
CGG_YA14-AU,1847,2567.10,70,114.80,1917,2681.90,20131001
CGG_YA15-AU,0,0.00,0,0.00,0,0.00,20131001
CGG_YA18-AU,1077,1962.55,77,203.60,1154,2166.15,20131001
CGG_YA20-AU,2095,3052.75,73,123.00,2168,3175.75,20131001
CGG_YA21-AU,1302,1694.40,50,85.00,1352,1779.40,20131001
CGG_YA23-AU,924,1332.40,28,51.60,952,1384.00,20131001
CGG_YA31-AU,1504,3206.45,74,217.60,1578,3424.05,20131001
CGG_YA32-AU,1122,2236.40,55,165.80,1177,2402.20,20131001
CGG_YA34-AU,790,1927.45,70,311.00,860,2238.45,20131001
CGG_YA35-AU,903,2424.05,58,258.20,961,2682.25,20131001
CGG_YA36-AU,556,1487.45,40,196.60,596,1684.05,20131001
CGG_YAX1-AU,959,2602.35,63,251.00,1022,2853.35,20131001
CGG_YAX2-AU,771,1890.40,60,220.00,831,2110.40,20131001
CGG_YAX3-AU,318,912.30,26,118.00,344,1030.30,20131001
CGG_YAX4-AU,456,1132.25,54,222.20,510,1354.45,20131001
CGG_YCX1-AU,394,908.15,39,152.00,433,1060.15,20131001
CGG_AP21-AU,642,1434.60,61,187.40,703,1622.00,20131101
CGG_BC21-AU,273,1002.55,151,1725.45,424,2728.00,20131101
CGG_BC41-AU,313,1079.20,191,924.00,504,2003.20,20131101
CGG_BC42-AU,114,414.05,73,360.00,187,774.05,20131101
CGG_BC43-AU,254,972.70,252,1237.60,506,2210.30,20131101
CGG_BR22-AU,548,1139.45,53,170.00,601,1309.45,20131101
CGG_BR23-AU,817,1997.20,93,366.60,910,2363.80,20131101
CGG_BR26-AU,903,1814.40,102,301.60,1005,2116.00,20131101
CGG_BR31-AU,1054,2463.85,16,60.00,1070,2523.85,20131101
CGG_BR32-AU,1039,2006.65,37,108.00,1076,2114.65,20131101
CGG_BR33-AU,369,820.70,74,334.60,443,1155.30,20131101
CGG_BR34-AU,1716,3167.10,74,194.80,1790,3361.90,20131101
CGG_BR35-AU,1088,2640.75,68,289.80,1156,2930.55,20131101
CGG_BR41-AU,187,699.95,32,155.00,219,854.95,20131101
CGG_BR42-AU,677,1611.90,105,357.80,782,1969.70,20131101
CGG_BR43-AU,110,418.30,106,527.00,216,945.30,20131101
CGG_BR44-AU,317,777.65,9,30.00,326,807.65,20131101
CGG_BR45-AU,118,463.35,86,420.00,204,883.35,20131101
CGG_BS11-AU,202,833.10,174,862.00,376,1695.10,20131101
CGG_BS12-AU,0,0.00,0,0.00,0,0.00,20131101
CGG_BS13-AU,208,879.50,155,765.00,363,1644.50,20131101
CGG_BS16-AU,202,834.50,64,316.00,266,1150.50,20131101
CGG_BS17-AU,627,1710.35,102,863.00,729,2573.35,20131101
CGG_BS18-AU,634,1563.20,71,315.00,705,1878.20,20131101
CGG_BS21-AU,1492,2899.25,85,267.20,1577,3166.45,20131101
CGG_BS22-AU,1073,1826.45,43,113.00,1116,1939.45,20131101
CGG_BS23-AU,1135,2212.40,70,201.20,1205,2413.60,20131101
CGG_BS24-AU,1293,2355.40,76,194.60,1369,2550.00,20131101
CGG_BS25-AU,1603,3292.10,110,310.00,1713,3602.10,20131101
CGG_BS26-AU,2111,4365.85,109,303.80,2220,4669.65,20131101
CGG_BS27-AU,2439,5412.10,163,514.40,2602,5926.50,20131101
CGG_BS29-AU,1043,2592.25,72,246.00,1115,2838.25,20131101
CGG_BS31-AU,861,2020.45,46,150.20,907,2170.65,20131101
CGG_BS32-AU,1338,3141.30,67,211.80,1405,3353.10,20131101
CGG_BS34-AU,130,313.25,6,20.00,136,333.25,20131101
CGG_BS35-AU,810,1998.90,27,85.20,837,2084.10,20131101
CGG_BS36-AU,2237,5516.20,118,355.40,2355,5871.60,20131101
CGG_BS37-AU,2053,5017.80,119,377.80,2172,5395.60,20131101
CGG_CCX1-AU,264,1250.15,189,2127.80,453,3377.95,20131101
CGG_CCX2-AU,335,1620.80,176,1901.00,511,3521.80,20131101
CGG_CCX3-AU,86,373.80,39,374.50,125,748.30,20131101
CGG_CCX4-AU,59,309.80,37,384.00,96,693.80,20131101
CGG_CCX5-AU,369,2411.05,217,2431.00,586,4842.05,20131101
CGG_CCX6-AU,78,437.85,117,1633.30,195,2071.15,20131101
CGG_CL11-AU,760,1516.85,81,240.20,841,1757.05,20131101
CGG_CLX2-AU,1020,2023.30,68,204.60,1088,2227.90,20131101
CGG_CPX1-AU,1906,5398.85,223,893.00,2129,6291.85,20131101
CGG_CPX2-AU,1221,3111.20,99,335.60,1320,3446.80,20131101
CGG_CS21-AU,950,2414.20,169,783.60,1119,3197.80,20131101
CGG_CS22-AU,728,1478.70,63,186.60,791,1665.30,20131101
CGG_EB29-AU,567,1518.25,59,211.00,626,1729.25,20131101
CGG_EB31-AU,790,2021.85,46,177.00,836,2198.85,20131101
CGG_EB32-AU,933,2259.50,93,345.60,1026,2605.10,20131101
CGG_EB33-AU,1784,4320.05,145,531.20,1929,4851.25,20131101
CGG_EB34-AU,1182,2517.15,65,221.40,1247,2738.55,20131101
CGG_EB35-AU,1361,3643.45,117,463.20,1478,4106.65,20131101
CGG_EB36-AU,1303,3338.55,102,390.80,1405,3729.35,20131101
CGG_EB41-AU,639,1985.50,67,386.00,706,2371.50,20131101
CGG_EB42-AU,234,874.70,126,626.00,360,1500.70,20131101
CGG_EB44-AU,133,456.25,153,763.00,286,1219.25,20131101
CGG_EB46-AU,0,0.00,0,0.00,0,0.00,20131101
CGG_FM21-AU,541,1980.45,214,2117.20,755,4097.65,20131101
CGG_FM22-AU,490,2003.75,193,2069.65,683,4073.40,20131101
CGG_FM23-AU,437,1538.35,265,2864.90,702,4403.25,20131101
CGG_FM24-AU,385,1431.05,226,2453.50,611,3884.55,20131101
CGG_FS21-AU,324,1051.75,122,1219.90,446,2271.65,20131101
CGG_FS22-AU,392,1001.35,62,271.60,454,1272.95,20131101
CGG_FS23-AU,160,610.05,120,1353.45,280,1963.50,20131101
CGG_FS24-AU,404,1119.55,77,343.60,481,1463.15,20131101
CGG_FS25-AU,414,1085.20,78,358.80,492,1444.00,20131101
CGG_FS26-AU,395,1189.90,56,250.60,451,1440.50,20131101
CGG_FS31-AU,864,1615.70,67,208.60,931,1824.30,20131101
CGG_FS32-AU,1037,2011.40,94,297.80,1131,2309.20,20131101
CGG_FS33-AU,1620,2733.60,101,318.40,1721,3052.00,20131101
CGG_GC13-AU,235,822.30,141,693.00,376,1515.30,20131101
CGG_GH15-AU,295,644.00,59,198.20,354,842.20,20131101
CGG_GH21-AU,646,1053.85,32,103.00,678,1156.85,20131101
CGG_GH23-AU,1319,2185.25,77,189.20,1396,2374.45,20131101
CGG_GH24-AU,2413,3028.50,122,192.40,2535,3220.90,20131101
CGG_GH31-AU,1659,2185.90,87,145.20,1746,2331.10,20131101
CGG_GH32-AU,1431,1930.00,88,156.60,1519,2086.60,20131101
CGG_GH33-AU,918,2190.60,105,457.20,1023,2647.80,20131101
CGG_GH34-AU,1057,2123.25,87,260.20,1144,2383.45,20131101
CGG_GH36-AU,1314,2632.40,47,146.60,1361,2779.00,20131101
CGG_GHX1-AU,1063,2866.85,119,491.80,1182,3358.65,20131101
CGG_GHX3-AU,577,1395.80,75,310.40,652,1706.20,20131101
CGG_GHX5-AU,487,1384.70,64,296.00,551,1680.70,20131101
CGG_GM11-AU,204,538.50,38,127.20,242,665.70,20131101
CGG_GM16-AU,193,460.65,44,174.00,237,634.65,20131101
CGG_HAY1-AU,358,2065.95,553,4022.20,911,6088.15,20131101
CGG_HAY2-AU,526,3020.95,601,4389.05,1127,7410.00,20131101
CGG_HAY3-AU,1619,7984.15,1271,9235.75,2890,17219.90,20131101
CGG_JSX1-AU,1335,2692.50,140,443.00,1475,3135.50,20131101
CGG_JSX2-AU,1705,2488.15,121,219.20,1826,2707.35,20131101
CGG_LM11-AU,1084,1999.10,73,222.80,1157,2221.90,20131101
CGG_LM12-AU,1076,1849.80,86,256.80,1162,2106.60,20131101
CGG_LM13-AU,890,1419.65,60,181.20,950,1600.85,20131101
CGG_LM14-AU,624,1029.65,50,150.80,674,1180.45,20131101
CGG_LM15-AU,669,1230.30,80,229.20,749,1459.50,20131101
CGG_LM16-AU,997,1963.60,79,240.20,1076,2203.80,20131101
CGG_LM30-AU,1282,1660.80,62,105.80,1344,1766.60,20131101
CGG_LM32-AU,2454,3250.05,106,177.60,2560,3427.65,20131101
CGG_LM41-AU,1163,1848.90,65,183.00,1228,2031.90,20131101
CGG_LM42-AU,1092,1605.40,57,127.20,1149,1732.60,20131101
CGG_LM43-AU,2013,2221.25,84,165.60,2097,2386.85,20131101
CGG_LM44-AU,2080,2825.90,87,213.60,2167,3039.50,20131101
CGG_LMX2-AU,413,1911.45,160,1430.95,573,3342.40,20131101
CGG_LR11-AU,760,1384.70,38,124.60,798,1509.30,20131101
CGG_LR12-AU,1290,2330.30,57,165.60,1347,2495.90,20131101
CGG_LR13-AU,2082,3774.25,112,314.20,2194,4088.45,20131101
CGG_LR14-AU,825,1430.95,49,142.80,874,1573.75,20131101
CGG_LR15-AU,226,805.30,86,408.00,312,1213.30,20131101
CGG_LR16-AU,926,1882.80,114,342.80,1040,2225.60,20131101
CGG_LR31-AU,413,1032.55,55,248.60,468,1281.15,20131101
CGG_LR33-AU,617,1587.35,62,249.60,679,1836.95,20131101
CGG_LR43-AU,873,2035.40,54,171.20,927,2206.60,20131101
CGG_LR47-AU,1320,3488.80,88,363.60,1408,3852.40,20131101
CGG_MB11-AU,981,1874.70,63,170.20,1044,2044.90,20131101
CGG_MB12-AU,1401,2697.10,94,243.80,1495,2940.90,20131101
CGG_MB13-AU,805,1463.30,16,48.00,821,1511.30,20131101
CGG_MB14-AU,1188,1582.95,39,66.20,1227,1649.15,20131101
CGG_MB15-AU,767,996.30,36,60.00,803,1056.30,20131101
CGG_MB16-AU,1034,1398.25,41,67.00,1075,1465.25,20131101
CGG_MB17-AU,1655,2088.05,89,147.00,1744,2235.05,20131101
CGG_MB23-AU,1894,2335.65,57,89.60,1951,2425.25,20131101
CGG_MB31-AU,2379,3332.55,109,283.20,2488,3615.75,20131101
CGG_MB32-AU,1959,2335.30,61,93.80,2020,2429.10,20131101
CGG_MB33-AU,2094,2950.15,77,177.40,2171,3127.55,20131101
CGG_MB34-AU,2029,2235.15,44,65.60,2073,2300.75,20131101
CGG_MB35-AU,1387,2026.05,69,192.20,1456,2218.25,20131101
CGG_MB36-AU,2950,3282.55,104,147.20,3054,3429.75,20131101
CGG_MB37-AU,1162,1745.55,37,86.20,1199,1831.75,20131101
CGG_MB38-AU,2035,2593.45,49,77.60,2084,2671.05,20131101
CGG_MB41-AU,1963,3248.25,93,236.20,2056,3484.45,20131101
CGG_MB42-AU,782,1672.65,22,70.00,804,1742.65,20131101
CGG_MB44-AU,1619,3225.15,93,262.40,1712,3487.55,20131101
CGG_MBX1-AU,1399,3280.50,118,358.60,1517,3639.10,20131101
CGG_MBX2-AU,1220,2760.10,132,402.80,1352,3162.90,20131101
CGG_MBX4-AU,976,2105.65,46,143.60,1022,2249.25,20131101
CGG_MC21-AU,1108,2597.50,103,714.90,1211,3312.40,20131101
CGG_MC22-AU,886,2099.30,69,545.55,955,2644.85,20131101
CGG_MC23-AU,762,1755.20,101,786.85,863,2542.05,20131101
CGG_MK31-AU,330,1029.20,17,76.60,347,1105.80,20131101
CGG_MK34-AU,241,664.10,52,235.60,293,899.70,20131101
CGG_MK35-AU,131,306.05,26,125.00,157,431.05,20131101
CGG_MM41-AU,2340,3535.35,95,193.00,2435,3728.35,20131101
CGG_MS10-AU,624,759.15,30,49.80,654,808.95,20131101
CGG_MS11-AU,1249,2148.80,83,200.40,1332,2349.20,20131101
CGG_MS12-AU,2130,2527.05,88,139.20,2218,2666.25,20131101
CGG_MS21-AU,1937,2515.60,74,122.00,2011,2637.60,20131101
CGG_MS30-AU,838,1101.95,38,61.40,876,1163.35,20131101
CGG_MS31-AU,2892,4123.85,157,251.20,3049,4375.05,20131101
CGG_MS32-AU,1787,2474.35,82,133.20,1869,2607.55,20131101
CGG_MS41-AU,1253,1591.65,60,89.60,1313,1681.25,20131101
CGG_MS42-AU,2259,2385.95,95,129.40,2354,2515.35,20131101
CGG_MS43-AU,2214,3239.50,95,228.20,2309,3467.70,20131101
CGG_MS44-AU,1749,2334.45,42,81.80,1791,2416.25,20131101
CGG_MS46-AU,1547,2048.50,57,103.00,1604,2151.50,20131101
CGG_MY21-AU,1020,1790.60,60,159.20,1080,1949.80,20131101
CGG_MY22-AU,233,488.75,12,41.00,245,529.75,20131101
CGG_MY23-AU,830,1502.20,30,82.60,860,1584.80,20131101
CGG_MY24-AU,0,0.00,0,0.00,0,0.00,20131101
CGG_MY25-AU,1371,2656.40,65,161.40,1436,2817.80,20131101
CGG_MY31-AU,629,1342.65,84,286.40,713,1629.05,20131101
CGG_MY32-AU,876,1969.25,79,257.60,955,2226.85,20131101
CGG_MY33-AU,418,951.85,49,174.00,467,1125.85,20131101
CGG_MY34-AU,572,1490.55,41,139.20,613,1629.75,20131101
CGG_MY35-AU,401,899.45,52,178.60,453,1078.05,20131101
CGG_MY41-AU,1957,3720.40,85,236.20,2042,3956.60,20131101
CGG_MY42-AU,2722,4606.95,103,255.20,2825,4862.15,20131101
CGG_MY43-AU,1009,2437.70,54,167.60,1063,2605.30,20131101
CGG_MY44-AU,542,1332.10,23,76.60,565,1408.70,20131101
CGG_MY45-AU,992,2517.30,55,172.00,1047,2689.30,20131101
CGG_MY46-AU,1880,4924.25,115,370.60,1995,5294.85,20131101
CGG_MY47-AU,1388,3553.70,98,290.80,1486,3844.50,20131101
CGG_MY51-AU,1175,3354.65,141,634.60,1316,3989.25,20131101
CGG_MY52-AU,1236,3901.05,211,1314.60,1447,5215.65,20131101
CGG_MY53-AU,742,2247.05,75,339.00,817,2586.05,20131101
CGG_MY54-AU,1041,3552.95,166,1034.60,1207,4587.55,20131101
CGG_MY55-AU,1245,3772.20,125,534.60,1370,4306.80,20131101
CGG_MY56-AU,1212,4259.55,185,1122.60,1397,5382.15,20131101
CGG_MY57-AU,1180,3514.60,130,574.40,1310,4089.00,20131101
CGG_PNR1-AU,843,2540.30,226,678.00,1069,3218.30,20131101
CGG_PNR2-AU,146,439.00,14,42.00,160,481.00,20131101
CGG_RBX4-AU,309,862.80,21,74.00,330,936.80,20131101
CGG_RBX5-AU,271,976.10,69,271.00,340,1247.10,20131101
CGG_RBX6-AU,401,1502.35,209,829.00,610,2331.35,20131101
CGG_RBX7-AU,306,1064.50,149,593.00,455,1657.50,20131101
CGG_RS11-AU,835,931.45,27,39.00,862,970.45,20131101
CGG_RS13-AU,696,805.10,24,38.60,720,843.70,20131101
CGG_RS14-AU,1732,1938.95,50,126.60,1782,2065.55,20131101
CGG_RS15-AU,977,1296.80,64,108.40,1041,1405.20,20131101
CGG_RS16-AU,1627,2289.50,97,268.20,1724,2557.70,20131101
CGG_RS20-AU,1610,2309.55,75,169.20,1685,2478.75,20131101
CGG_RS21-AU,2019,2476.05,80,119.20,2099,2595.25,20131101
CGG_RS22-AU,2733,3813.15,120,268.00,2853,4081.15,20131101
CGG_RS23-AU,1989,2402.75,103,158.80,2092,2561.55,20131101
CGG_RS30-AU,1717,2541.10,89,201.60,1806,2742.70,20131101
CGG_RS31-AU,2073,2622.95,88,140.00,2161,2762.95,20131101
CGG_RS32-AU,1356,2374.35,127,390.80,1483,2765.15,20131101
CGG_RS33-AU,1475,1966.00,70,118.80,1545,2084.80,20131101
CGG_RS41-AU,1476,2532.10,129,341.00,1605,2873.10,20131101
CGG_RS42-AU,1586,2991.95,78,211.00,1664,3202.95,20131101
CGG_RS43-AU,866,1516.65,53,133.40,919,1650.05,20131101
CGG_RS44-AU,624,1209.90,37,107.60,661,1317.50,20131101
CGG_RS45-AU,1678,2968.80,107,286.20,1785,3255.00,20131101
CGG_RS46-AU,1015,2155.05,45,129.20,1060,2284.25,20131101
CGG_RS50-AU,495,839.15,30,58.60,525,897.75,20131101
CGG_RS53-AU,905,2003.55,67,203.80,972,2207.35,20131101
CGG_RSX1-AU,269,545.25,16,56.00,285,601.25,20131101
CGG_RSX2-AU,696,1168.25,36,86.00,732,1254.25,20131101
CGG_RSX3-AU,490,1064.00,37,131.60,527,1195.60,20131101
CGG_RT12-AU,1184,2963.65,85,335.40,1269,3299.05,20131101
CGG_SS31-AU,885,1663.65,45,197.20,930,1860.85,20131101
CGG_SS32-AU,675,1350.45,30,88.80,705,1439.25,20131101
CGG_SW30-AU,437,1357.20,64,589.00,501,1946.20,20131101
CGG_SW31-AU,1317,3145.30,71,236.60,1388,3381.90,20131101
CGG_SW32-AU,411,1350.05,76,710.00,487,2060.05,20131101
CGG_SW33-AU,631,1611.80,52,174.20,683,1786.00,20131101
CGG_SW34-AU,572,2060.85,194,1869.00,766,3929.85,20131101
CGG_SW35-AU,685,1842.05,43,151.00,728,1993.05,20131101
CGG_TM10-AU,2238,5513.90,482,1770.55,2720,7284.45,20131101
CGG_TMX3-AU,1154,3695.85,248,1411.50,1402,5107.35,20131101
CGG_TMX4-AU,2014,6330.35,308,1563.00,2322,7893.35,20131101
CGG_TMX5-AU,2058,5823.95,456,2572.30,2514,8396.25,20131101
CGG_TMX6-AU,1941,6018.70,467,2702.65,2408,8721.35,20131101
CGG_TMX7-AU,1628,4150.00,351,1316.65,1979,5466.65,20131101
CGG_TMX8-AU,2780,6920.05,1015,3852.65,3795,10772.70,20131101
CGG_TMX9-AU,2853,6801.65,420,1539.75,3273,8341.40,20131101
CGG_TPX1-AU,1277,2575.90,196,599.00,1473,3174.90,20131101
CGG_US10-AU,1384,1872.65,50,72.60,1434,1945.25,20131101
CGG_WES1-AU,474,1754.05,122,719.75,596,2473.80,20131101
CGG_WES2-AU,910,3285.90,152,841.70,1062,4127.60,20131101
CGG_YA11-AU,988,1409.05,37,65.80,1025,1474.85,20131101
CGG_YA13-AU,2407,3284.00,96,164.40,2503,3448.40,20131101
CGG_YA14-AU,1816,2470.50,81,134.20,1897,2604.70,20131101
CGG_YA15-AU,0,0.00,0,0.00,0,0.00,20131101
CGG_YA18-AU,1241,2240.20,67,157.00,1308,2397.20,20131101
CGG_YA20-AU,2019,2997.95,82,135.80,2101,3133.75,20131101
CGG_YA21-AU,1346,1818.25,30,48.40,1376,1866.65,20131101
CGG_YA23-AU,983,1453.15,37,61.80,1020,1514.95,20131101
CGG_YA31-AU,1671,3344.65,58,178.80,1729,3523.45,20131101
CGG_YA32-AU,1254,2394.30,65,194.20,1319,2588.50,20131101
CGG_YA34-AU,884,2069.30,71,294.20,955,2363.50,20131101
CGG_YA35-AU,919,2535.90,77,358.20,996,2894.10,20131101
CGG_YA36-AU,553,1510.35,47,188.20,600,1698.55,20131101
CGG_YAX1-AU,988,2690.15,113,448.40,1101,3138.55,20131101
CGG_YAX2-AU,799,1984.70,72,249.60,871,2234.30,20131101
CGG_YAX3-AU,313,882.10,47,205.20,360,1087.30,20131101
CGG_YAX4-AU,477,1155.80,38,143.20,515,1299.00,20131101
CGG_YCX1-AU,336,800.05,35,143.00,371,943.05,20131101
CGG_AP21-AU,422,952.90,52,197.00,474,1149.90,20131201
CGG_BC21-AU,266,945.20,163,1748.00,429,2693.20,20131201
CGG_BC41-AU,310,1042.75,169,823.60,479,1866.35,20131201
CGG_BC42-AU,131,489.30,70,338.60,201,827.90,20131201
CGG_BC43-AU,258,911.35,237,1171.00,495,2082.35,20131201
CGG_BR22-AU,645,1463.10,71,243.60,716,1706.70,20131201
CGG_BR23-AU,928,2467.35,52,216.60,980,2683.95,20131201
CGG_BR26-AU,874,1860.95,94,281.80,968,2142.75,20131201
CGG_BR31-AU,1183,2970.50,24,93.00,1207,3063.50,20131201
CGG_BR32-AU,1025,2166.85,65,194.20,1090,2361.05,20131201
CGG_BR33-AU,377,900.65,51,225.00,428,1125.65,20131201
CGG_BR34-AU,1474,3041.35,81,216.20,1555,3257.55,20131201
CGG_BR35-AU,1300,3277.30,104,430.60,1404,3707.90,20131201
CGG_BR41-AU,211,742.15,24,112.00,235,854.15,20131201
CGG_BR42-AU,677,1685.00,103,377.20,780,2062.20,20131201
CGG_BR43-AU,101,391.15,81,403.00,182,794.15,20131201
CGG_BR44-AU,375,1032.05,18,60.60,393,1092.65,20131201
CGG_BR45-AU,133,512.85,73,362.00,206,874.85,20131201
CGG_BS11-AU,285,1127.10,157,773.00,442,1900.10,20131201
CGG_BS12-AU,0,0.00,0,0.00,0,0.00,20131201
CGG_BS13-AU,239,963.05,135,670.00,374,1633.05,20131201
CGG_BS16-AU,187,714.85,76,367.00,263,1081.85,20131201
CGG_BS17-AU,806,2294.10,94,675.00,900,2969.10,20131201
CGG_BS18-AU,666,1748.05,81,342.00,747,2090.05,20131201
CGG_BS21-AU,1548,3121.65,84,256.80,1632,3378.45,20131201
CGG_BS22-AU,1231,2160.70,50,139.40,1281,2300.10,20131201
CGG_BS23-AU,1037,2165.20,42,118.80,1079,2284.00,20131201
CGG_BS24-AU,1294,2341.95,63,166.60,1357,2508.55,20131201
CGG_BS25-AU,1376,2893.60,84,233.40,1460,3127.00,20131201
CGG_BS26-AU,1951,3966.15,108,292.40,2059,4258.55,20131201
CGG_BS27-AU,2066,4593.85,125,386.20,2191,4980.05,20131201
CGG_BS29-AU,907,2182.10,68,226.80,975,2408.90,20131201
CGG_BS31-AU,806,1952.95,51,166.00,857,2118.95,20131201
CGG_BS32-AU,1168,2763.25,72,217.40,1240,2980.65,20131201
CGG_BS34-AU,143,329.90,6,18.00,149,347.90,20131201
CGG_BS35-AU,760,1810.25,38,130.60,798,1940.85,20131201
CGG_BS36-AU,2058,4864.00,130,429.60,2188,5293.60,20131201
CGG_BS37-AU,1853,4602.35,106,336.80,1959,4939.15,20131201
CGG_CCX1-AU,240,1142.30,181,1787.20,421,2929.50,20131201
CGG_CCX2-AU,286,1342.70,158,1674.00,444,3016.70,20131201
CGG_CCX3-AU,57,300.35,37,384.40,94,684.75,20131201
CGG_CCX4-AU,38,205.60,29,223.10,67,428.70,20131201
CGG_CCX5-AU,230,1325.75,202,2051.20,432,3376.95,20131201
CGG_CCX6-AU,90,399.05,77,862.50,167,1261.55,20131201
CGG_CL11-AU,924,2042.75,75,232.80,999,2275.55,20131201
CGG_CLX2-AU,1040,2109.15,63,200.00,1103,2309.15,20131201
CGG_CPX1-AU,2187,6200.35,261,1068.40,2448,7268.75,20131201
CGG_CPX2-AU,1200,3187.00,123,437.20,1323,3624.20,20131201
CGG_CS21-AU,877,2464.00,177,834.80,1054,3298.80,20131201
CGG_CS22-AU,836,1821.00,80,234.80,916,2055.80,20131201
CGG_EB29-AU,523,1478.15,49,191.60,572,1669.75,20131201
CGG_EB31-AU,725,1891.80,60,218.00,785,2109.80,20131201
CGG_EB32-AU,805,1927.10,81,300.20,886,2227.30,20131201
CGG_EB33-AU,1732,4430.60,155,578.00,1887,5008.60,20131201
CGG_EB34-AU,891,1952.50,45,148.20,936,2100.70,20131201
CGG_EB35-AU,1403,3784.25,144,604.20,1547,4388.45,20131201
CGG_EB36-AU,1410,3638.80,132,511.40,1542,4150.20,20131201
CGG_EB41-AU,683,2156.60,85,526.00,768,2682.60,20131201
CGG_EB42-AU,254,930.10,104,512.00,358,1442.10,20131201
CGG_EB44-AU,172,606.15,138,670.00,310,1276.15,20131201
CGG_EB46-AU,0,0.00,0,0.00,0,0.00,20131201
CGG_FM21-AU,426,1431.85,164,1720.35,590,3152.20,20131201
CGG_FM22-AU,256,990.50,178,1927.70,434,2918.20,20131201
CGG_FM23-AU,260,894.35,224,2483.05,484,3377.40,20131201
CGG_FM24-AU,282,997.00,188,2203.20,470,3200.20,20131201
CGG_FS21-AU,204,621.80,62,658.40,266,1280.20,20131201
CGG_FS22-AU,274,680.75,28,111.00,302,791.75,20131201
CGG_FS23-AU,119,402.80,98,1193.85,217,1596.65,20131201
CGG_FS24-AU,278,680.30,55,261.60,333,941.90,20131201
CGG_FS25-AU,296,770.00,70,351.00,366,1121.00,20131201
CGG_FS26-AU,324,872.20,53,247.00,377,1119.20,20131201
CGG_FS31-AU,666,1217.40,53,171.20,719,1388.60,20131201
CGG_FS32-AU,855,1690.40,68,195.60,923,1886.00,20131201
CGG_FS33-AU,1177,2046.70,73,206.00,1250,2252.70,20131201
CGG_GC13-AU,243,925.05,109,528.00,352,1453.05,20131201
CGG_GH15-AU,264,595.20,51,183.60,315,778.80,20131201
CGG_GH21-AU,498,885.60,24,75.00,522,960.60,20131201
CGG_GH23-AU,1014,1769.75,78,218.00,1092,1987.75,20131201
CGG_GH24-AU,1876,2521.30,92,160.20,1968,2681.50,20131201
CGG_GH31-AU,1742,2290.05,71,116.40,1813,2406.45,20131201
CGG_GH32-AU,1293,1747.35,57,96.60,1350,1843.95,20131201
CGG_GH33-AU,848,1910.05,76,326.60,924,2236.65,20131201
CGG_GH34-AU,920,1832.55,71,210.20,991,2042.75,20131201
CGG_GH36-AU,916,1988.70,48,139.20,964,2127.90,20131201
CGG_GHX1-AU,851,2464.55,126,572.00,977,3036.55,20131201
CGG_GHX3-AU,376,1046.65,81,401.60,457,1448.25,20131201
CGG_GHX5-AU,538,1625.25,68,323.00,606,1948.25,20131201
CGG_GM11-AU,182,542.75,31,109.00,213,651.75,20131201
CGG_GM16-AU,200,544.35,28,102.00,228,646.35,20131201
CGG_HAY1-AU,211,1104.25,509,3681.30,720,4785.55,20131201
CGG_HAY2-AU,576,3321.15,529,3836.60,1105,7157.75,20131201
CGG_HAY3-AU,1269,5934.35,1175,8516.75,2444,14451.10,20131201
CGG_JSX1-AU,1149,2469.35,117,364.80,1266,2834.15,20131201
CGG_JSX2-AU,1472,2187.85,88,153.60,1560,2341.45,20131201
CGG_LM11-AU,846,1490.50,61,177.20,907,1667.70,20131201
CGG_LM12-AU,823,1389.70,53,164.20,876,1553.90,20131201
CGG_LM13-AU,646,1004.80,31,88.20,677,1093.00,20131201
CGG_LM14-AU,514,765.00,31,87.20,545,852.20,20131201
CGG_LM15-AU,481,896.00,59,192.20,540,1088.20,20131201
CGG_LM16-AU,741,1507.65,78,241.80,819,1749.45,20131201
CGG_LM30-AU,1196,1624.15,42,70.40,1238,1694.55,20131201
CGG_LM32-AU,2210,3061.05,107,170.80,2317,3231.85,20131201
CGG_LM41-AU,1232,2205.90,50,129.40,1282,2335.30,20131201
CGG_LM42-AU,1004,1717.55,62,165.40,1066,1882.95,20131201
CGG_LM43-AU,1823,2218.80,57,107.80,1880,2326.60,20131201
CGG_LM44-AU,1968,2726.55,81,179.60,2049,2906.15,20131201
CGG_LMX2-AU,260,869.80,130,1156.55,390,2026.35,20131201
CGG_LR11-AU,652,1229.65,36,102.20,688,1331.85,20131201
CGG_LR12-AU,965,1698.25,72,213.40,1037,1911.65,20131201
CGG_LR13-AU,1788,3170.95,96,266.60,1884,3437.55,20131201
CGG_LR14-AU,765,1351.50,40,108.20,805,1459.70,20131201
CGG_LR15-AU,194,684.85,59,279.00,253,963.85,20131201
CGG_LR16-AU,780,1607.25,83,227.60,863,1834.85,20131201
CGG_LR31-AU,372,983.85,53,196.40,425,1180.25,20131201
CGG_LR33-AU,635,1572.85,67,305.20,702,1878.05,20131201
CGG_LR43-AU,712,1738.50,47,160.00,759,1898.50,20131201
CGG_LR47-AU,1120,2876.55,97,381.20,1217,3257.75,20131201
CGG_MB11-AU,985,2037.55,51,147.40,1036,2184.95,20131201
CGG_MB12-AU,1304,2745.85,111,354.60,1415,3100.45,20131201
CGG_MB13-AU,809,1677.45,31,81.00,840,1758.45,20131201
CGG_MB14-AU,901,1282.65,35,61.20,936,1343.85,20131201
CGG_MB15-AU,665,915.00,27,46.20,692,961.20,20131201
CGG_MB16-AU,1024,1412.60,37,60.00,1061,1472.60,20131201
CGG_MB17-AU,1524,2096.95,89,142.60,1613,2239.55,20131201
CGG_MB23-AU,1811,2344.85,52,88.20,1863,2433.05,20131201
CGG_MB31-AU,2231,3195.85,87,201.60,2318,3397.45,20131201
CGG_MB32-AU,2115,2541.45,73,103.20,2188,2644.65,20131201
CGG_MB33-AU,2064,2995.40,72,176.20,2136,3171.60,20131201
CGG_MB34-AU,1888,2152.50,50,73.40,1938,2225.90,20131201
CGG_MB35-AU,1548,2380.05,86,227.00,1634,2607.05,20131201
CGG_MB36-AU,2964,3423.35,114,175.60,3078,3598.95,20131201
CGG_MB37-AU,1342,2044.50,57,164.80,1399,2209.30,20131201
CGG_MB38-AU,2503,3087.80,74,100.40,2577,3188.20,20131201
CGG_MB41-AU,1895,2968.55,98,220.40,1993,3188.95,20131201
CGG_MB42-AU,790,1595.15,24,81.00,814,1676.15,20131201
CGG_MB44-AU,1628,3153.30,82,244.60,1710,3397.90,20131201
CGG_MBX1-AU,1402,3391.85,107,336.60,1509,3728.45,20131201
CGG_MBX2-AU,1180,2780.45,117,399.80,1297,3180.25,20131201
CGG_MBX4-AU,970,2187.00,56,176.20,1026,2363.20,20131201
CGG_MC21-AU,878,2005.50,79,661.45,957,2666.95,20131201
CGG_MC22-AU,720,1458.40,64,444.85,784,1903.25,20131201
CGG_MC23-AU,970,2264.55,82,540.80,1052,2805.35,20131201
CGG_MK31-AU,319,1108.70,37,171.60,356,1280.30,20131201
CGG_MK34-AU,217,597.90,37,171.60,254,769.50,20131201
CGG_MK35-AU,153,383.00,17,72.00,170,455.00,20131201
CGG_MM41-AU,2151,3555.90,79,194.60,2230,3750.50,20131201
CGG_MS10-AU,647,832.70,35,49.80,682,882.50,20131201
CGG_MS11-AU,1230,2159.55,79,218.60,1309,2378.15,20131201
CGG_MS12-AU,2107,2681.55,80,112.00,2187,2793.55,20131201
CGG_MS21-AU,1891,2640.70,78,128.80,1969,2769.50,20131201
CGG_MS30-AU,839,1164.35,34,56.00,873,1220.35,20131201
CGG_MS31-AU,2630,3900.50,137,241.60,2767,4142.10,20131201
CGG_MS32-AU,1663,2438.55,64,105.60,1727,2544.15,20131201
CGG_MS41-AU,1273,1777.55,52,79.20,1325,1856.75,20131201
CGG_MS42-AU,2072,2492.20,93,144.80,2165,2637.00,20131201
CGG_MS43-AU,2311,3858.90,108,270.60,2419,4129.50,20131201
CGG_MS44-AU,1597,2496.50,72,168.20,1669,2664.70,20131201
CGG_MS46-AU,1560,2255.85,50,114.40,1610,2370.25,20131201
CGG_MY21-AU,930,1557.25,28,64.40,958,1621.65,20131201
CGG_MY22-AU,270,576.80,11,36.00,281,612.80,20131201
CGG_MY23-AU,815,1422.80,34,85.00,849,1507.80,20131201
CGG_MY24-AU,0,0.00,0,0.00,0,0.00,20131201
CGG_MY25-AU,1205,2270.75,53,141.80,1258,2412.55,20131201
CGG_MY31-AU,642,1281.95,65,221.40,707,1503.35,20131201
CGG_MY32-AU,771,1554.15,60,186.40,831,1740.55,20131201
CGG_MY33-AU,362,842.75,27,89.00,389,931.75,20131201
CGG_MY34-AU,501,1277.70,29,97.60,530,1375.30,20131201
CGG_MY35-AU,342,801.25,28,96.60,370,897.85,20131201
CGG_MY41-AU,1636,3076.30,83,212.60,1719,3288.90,20131201
CGG_MY42-AU,2494,3978.20,108,276.80,2602,4255.00,20131201
CGG_MY43-AU,779,1899.60,49,156.20,828,2055.80,20131201
CGG_MY44-AU,442,1122.40,17,49.60,459,1172.00,20131201
CGG_MY45-AU,744,1931.15,54,168.80,798,2099.95,20131201
CGG_MY46-AU,1547,4071.75,111,353.00,1658,4424.75,20131201
CGG_MY47-AU,1249,3123.25,87,269.60,1336,3392.85,20131201
CGG_MY51-AU,1091,3167.60,121,493.80,1212,3661.40,20131201
CGG_MY52-AU,1135,3661.80,195,1168.60,1330,4830.40,20131201
CGG_MY53-AU,606,1817.55,73,342.20,679,2159.75,20131201
CGG_MY54-AU,905,3134.80,120,692.60,1025,3827.40,20131201
CGG_MY55-AU,990,2946.20,105,495.00,1095,3441.20,20131201
CGG_MY56-AU,994,3611.45,151,956.20,1145,4567.65,20131201
CGG_MY57-AU,1003,3069.45,86,355.00,1089,3424.45,20131201
CGG_PNR1-AU,715,2159.20,222,666.00,937,2825.20,20131201
CGG_PNR2-AU,92,278.40,20,60.00,112,338.40,20131201
CGG_RBX4-AU,394,1103.15,27,93.00,421,1196.15,20131201
CGG_RBX5-AU,312,1135.90,83,331.00,395,1466.90,20131201
CGG_RBX6-AU,434,1570.90,184,722.00,618,2292.90,20131201
CGG_RBX7-AU,332,1149.80,112,443.00,444,1592.80,20131201
CGG_RS11-AU,746,852.40,26,40.60,772,893.00,20131201
CGG_RS13-AU,533,599.90,23,34.20,556,634.10,20131201
CGG_RS14-AU,1520,1628.35,38,82.00,1558,1710.35,20131201
CGG_RS15-AU,903,1181.25,50,86.40,953,1267.65,20131201
CGG_RS16-AU,1489,1858.00,69,193.00,1558,2051.00,20131201
CGG_RS20-AU,1593,2221.45,82,198.40,1675,2419.85,20131201
CGG_RS21-AU,1754,2199.85,68,103.80,1822,2303.65,20131201
CGG_RS22-AU,2649,3918.50,111,267.00,2760,4185.50,20131201
CGG_RS23-AU,1943,2422.10,74,110.20,2017,2532.30,20131201
CGG_RS30-AU,1624,2626.50,93,247.40,1717,2873.90,20131201
CGG_RS31-AU,2102,2890.05,81,137.20,2183,3027.25,20131201
CGG_RS32-AU,1375,2347.90,84,249.00,1459,2596.90,20131201
CGG_RS33-AU,1579,2230.55,58,91.20,1637,2321.75,20131201
CGG_RS41-AU,1421,2545.60,87,228.20,1508,2773.80,20131201
CGG_RS42-AU,1242,2448.25,81,218.40,1323,2666.65,20131201
CGG_RS43-AU,743,1336.35,32,93.20,775,1429.55,20131201
CGG_RS44-AU,575,1111.05,40,118.60,615,1229.65,20131201
CGG_RS45-AU,1516,2642.05,91,240.20,1607,2882.25,20131201
CGG_RS46-AU,865,1770.60,57,162.00,922,1932.60,20131201
CGG_RS50-AU,416,721.05,16,29.20,432,750.25,20131201
CGG_RS53-AU,788,1783.20,46,143.60,834,1926.80,20131201
CGG_RSX1-AU,286,496.55,13,37.60,299,534.15,20131201
CGG_RSX2-AU,586,1010.75,32,99.60,618,1110.35,20131201
CGG_RSX3-AU,489,1028.80,31,102.20,520,1131.00,20131201
CGG_RT12-AU,968,2312.25,77,355.20,1045,2667.45,20131201
CGG_SS31-AU,841,1446.05,59,259.20,900,1705.25,20131201
CGG_SS32-AU,638,1097.95,37,125.40,675,1223.35,20131201
CGG_SW30-AU,441,1244.50,59,518.00,500,1762.50,20131201
CGG_SW31-AU,1205,2878.20,76,249.60,1281,3127.80,20131201
CGG_SW32-AU,379,1143.35,92,830.00,471,1973.35,20131201
CGG_SW33-AU,544,1296.75,33,118.00,577,1414.75,20131201
CGG_SW34-AU,576,1998.80,152,1547.00,728,3545.80,20131201
CGG_SW35-AU,543,1348.05,40,124.80,583,1472.85,20131201
CGG_TM10-AU,2075,4860.25,427,1594.65,2502,6454.90,20131201
CGG_TMX3-AU,1318,4255.75,249,1410.65,1567,5666.40,20131201
CGG_TMX4-AU,2351,7575.45,329,1608.85,2680,9184.30,20131201
CGG_TMX5-AU,2207,6625.15,418,2399.15,2625,9024.30,20131201
CGG_TMX6-AU,2009,6316.80,476,2694.35,2485,9011.15,20131201
CGG_TMX7-AU,1499,3624.20,259,969.95,1758,4594.15,20131201
CGG_TMX8-AU,2546,6192.50,832,3158.70,3378,9351.20,20131201
CGG_TMX9-AU,2830,6431.50,429,1570.80,3259,8002.30,20131201
CGG_TPX1-AU,1199,2308.95,179,557.90,1378,2866.85,20131201
CGG_US10-AU,1461,2081.90,33,56.80,1494,2138.70,20131201
CGG_WES1-AU,490,1820.20,88,481.65,578,2301.85,20131201
CGG_WES2-AU,897,3234.35,162,886.00,1059,4120.35,20131201
CGG_YA11-AU,1011,1571.00,45,86.00,1056,1657.00,20131201
CGG_YA13-AU,2260,3330.40,97,168.80,2357,3499.20,20131201
CGG_YA14-AU,1677,2550.60,81,139.80,1758,2690.40,20131201
CGG_YA15-AU,0,0.00,0,0.00,0,0.00,20131201
CGG_YA18-AU,1111,2317.20,73,204.80,1184,2522.00,20131201
CGG_YA20-AU,1927,2957.20,73,120.00,2000,3077.20,20131201
CGG_YA21-AU,1310,1804.70,55,100.60,1365,1905.30,20131201
CGG_YA23-AU,1185,1801.90,41,72.00,1226,1873.90,20131201
CGG_YA31-AU,1632,3424.25,73,201.60,1705,3625.85,20131201
CGG_YA32-AU,1167,2238.05,63,190.20,1230,2428.25,20131201
CGG_YA34-AU,872,2285.80,93,414.60,965,2700.40,20131201
CGG_YA35-AU,919,2583.00,80,336.20,999,2919.20,20131201
CGG_YA36-AU,684,1782.70,42,194.00,726,1976.70,20131201
CGG_YAX1-AU,1030,2807.45,116,476.00,1146,3283.45,20131201
CGG_YAX2-AU,799,2031.20,71,247.20,870,2278.40,20131201
CGG_YAX3-AU,456,1267.30,43,205.00,499,1472.30,20131201
CGG_YAX4-AU,554,1515.80,51,188.60,605,1704.40,20131201
CGG_YCX1-AU,492,1157.85,51,212.00,543,1369.85,20131201
CGG_AP21-AU,287,690.85,101,421.85,388,1112.70,20150401
CGG_BC13-AU,103,517.00,113,664.00,216,1181.00,20150401
CGG_BC14-AU,96,449.15,158,934.75,254,1383.90,20150401
CGG_BC21-AU,192,887.55,208,2538.75,400,3426.30,20150401
CGG_BC41-AU,244,1013.80,191,1093.20,435,2107.00,20150401
CGG_BC42-AU,101,392.15,52,286.85,153,679.00,20150401
CGG_BC43-AU,182,758.40,285,1659.50,467,2417.90,20150401
CGG_BR14-AU,145,463.50,56,239.95,201,703.45,20150401
CGG_BR15-AU,210,701.55,129,596.20,339,1297.75,20150401
CGG_BR16-AU,238,668.40,81,359.35,319,1027.75,20150401
CGG_BR22-AU,503,1342.85,143,589.20,646,1932.05,20150401
CGG_BR23-AU,513,1637.70,233,1261.80,746,2899.50,20150401
CGG_BR26-AU,680,1643.20,159,601.80,839,2245.00,20150401
CGG_BR31-AU,738,2005.65,174,869.85,912,2875.50,20150401
CGG_BR32-AU,676,1541.60,86,287.40,762,1829.00,20150401
CGG_BR33-AU,252,624.15,55,300.00,307,924.15,20150401
CGG_BR34-AU,1448,2870.75,97,310.40,1545,3181.15,20150401
CGG_BR35-AU,841,2118.20,122,589.20,963,2707.40,20150401
CGG_BR41-AU,119,506.30,144,826.85,263,1333.15,20150401
CGG_BR42-AU,577,1496.00,142,587.45,719,2083.45,20150401
CGG_BR43-AU,90,401.80,124,729.60,214,1131.40,20150401
CGG_BR44-AU,243,655.95,54,229.35,297,885.30,20150401
CGG_BR45-AU,65,339.30,134,796.60,199,1135.90,20150401
CGG_BS11-AU,109,615.50,201,1195.20,310,1810.70,20150401
CGG_BS12-AU,302,1002.30,69,323.70,371,1326.00,20150401
CGG_BS13-AU,99,537.20,178,1057.20,277,1594.40,20150401
CGG_BS16-AU,88,395.95,127,742.60,215,1138.55,20150401
CGG_BS17-AU,481,1458.10,91,719.30,572,2177.40,20150401
CGG_BS18-AU,452,1226.35,120,617.05,572,1843.40,20150401
CGG_BS21-AU,1339,2983.50,139,427.20,1478,3410.70,20150401
CGG_BS22-AU,951,1793.25,59,198.70,1010,1991.95,20150401
CGG_BS23-AU,975,2317.60,130,401.55,1105,2719.15,20150401
CGG_BS24-AU,1065,2217.35,109,377.35,1174,2594.70,20150401
CGG_BS25-AU,1179,2832.05,143,480.40,1322,3312.45,20150401
CGG_BS26-AU,1838,4292.00,222,705.05,2060,4997.05,20150401
CGG_BS27-AU,2084,5425.70,242,874.70,2326,6300.40,20150401
CGG_BS29-AU,823,2370.95,120,498.70,943,2869.65,20150401
CGG_BS31-AU,624,1789.95,99,402.45,723,2192.40,20150401
CGG_BS32-AU,1027,2794.90,132,500.45,1159,3295.35,20150401
CGG_BS34-AU,139,383.50,8,33.75,147,417.25,20150401
CGG_BS35-AU,631,1839.05,80,293.60,711,2132.65,20150401
CGG_BS36-AU,1794,5131.60,227,874.25,2021,6005.85,20150401
CGG_BS37-AU,1632,4788.60,199,737.20,1831,5525.80,20150401
CGG_BS51-AU,497,1772.00,127,699.30,624,2471.30,20150401
CGG_BS52-AU,374,1391.15,85,452.40,459,1843.55,20150401
CGG_BS53-AU,606,2478.00,138,788.65,744,3266.65,20150401
CGG_BS54-AU,586,2214.80,119,650.00,705,2864.80,20150401
CGG_CCX1-AU,134,779.60,180,2202.40,314,2982.00,20150401
CGG_CCX2-AU,182,1220.90,171,2258.00,353,3478.90,20150401
CGG_CCX3-AU,39,221.25,38,421.80,77,643.05,20150401
CGG_CCX4-AU,24,117.80,55,618.10,79,735.90,20150401
CGG_CCX5-AU,195,1444.95,200,2560.50,395,4005.45,20150401
CGG_CCX6-AU,36,273.80,116,1706.20,152,1980.00,20150401
CGG_CL11-AU,739,1912.50,155,596.05,894,2508.55,20150401
CGG_CLX2-AU,863,1919.00,132,503.05,995,2422.05,20150401
CGG_CPX1-AU,1725,5901.40,509,2729.75,2234,8631.15,20150401
CGG_CPX2-AU,1030,3657.70,349,1864.75,1379,5522.45,20150401
CGG_CS21-AU,753,2482.40,247,1432.35,1000,3914.75,20150401
CGG_CS22-AU,657,1632.70,103,388.65,760,2021.35,20150401
CGG_CUX2-AU,279,764.40,111,432.95,390,1197.35,20150401
CGG_EB29-AU,345,1107.70,80,404.95,425,1512.65,20150401
CGG_EB31-AU,546,1638.75,107,507.45,653,2146.20,20150401
CGG_EB32-AU,727,1890.80,128,604.95,855,2495.75,20150401
CGG_EB33-AU,1203,3265.75,197,959.25,1400,4225.00,20150401
CGG_EB34-AU,476,1169.75,56,223.10,532,1392.85,20150401
CGG_EB35-AU,1022,3010.95,229,1047.25,1251,4058.20,20150401
CGG_EB36-AU,1133,3233.40,179,797.95,1312,4031.35,20150401
CGG_EB41-AU,646,2150.05,133,1013.10,779,3163.15,20150401
CGG_EB42-AU,167,772.60,83,484.25,250,1256.85,20150401
CGG_EB44-AU,59,307.00,158,941.60,217,1248.60,20150401
CGG_EB46-AU,57,266.25,107,640.00,164,906.25,20150401
CGG_FM21-AU,443,1842.60,227,2658.05,670,4500.65,20150401
CGG_FM22-AU,337,1292.45,270,3438.70,607,4731.15,20150401
CGG_FM23-AU,328,1141.95,271,3641.85,599,4783.80,20150401
CGG_FM24-AU,273,1049.40,253,3191.75,526,4241.15,20150401
CGG_FS21-AU,253,1041.45,114,1313.70,367,2355.15,20150401
CGG_FS22-AU,239,740.60,76,385.60,315,1126.20,20150401
CGG_FS23-AU,173,498.05,135,1586.80,308,2084.85,20150401
CGG_FS24-AU,291,838.75,79,429.35,370,1268.10,20150401
CGG_FS25-AU,404,1145.45,101,507.30,505,1652.75,20150401
CGG_FS26-AU,288,863.65,112,634.95,400,1498.60,20150401
CGG_FS31-AU,821,1788.35,73,253.70,894,2042.05,20150401
CGG_FS32-AU,821,1914.05,132,470.45,953,2384.50,20150401
CGG_FS33-AU,1528,2941.55,128,420.40,1656,3361.95,20150401
CGG_GC13-AU,165,715.50,186,1061.75,351,1777.25,20150401
CGG_GH11-AU,150,440.50,58,248.05,208,688.55,20150401
CGG_GH15-AU,174,556.30,76,343.05,250,899.35,20150401
CGG_GH21-AU,396,821.10,43,147.45,439,968.55,20150401
CGG_GH23-AU,888,1566.50,115,388.55,1003,1955.05,20150401
CGG_GH24-AU,1370,2719.05,189,615.25,1559,3334.30,20150401
CGG_GH31-AU,1308,2513.55,183,571.65,1491,3085.20,20150401
CGG_GH32-AU,969,1811.45,125,371.05,1094,2182.50,20150401
CGG_GH33-AU,688,1730.55,67,310.50,755,2041.05,20150401
CGG_GH34-AU,720,1653.00,78,268.65,798,1921.65,20150401
CGG_GH36-AU,1418,3397.85,82,302.45,1500,3700.30,20150401
CGG_GHX1-AU,908,3289.45,358,2069.85,1266,5359.30,20150401
CGG_GHX3-AU,554,1901.60,285,1598.60,839,3500.20,20150401
CGG_GHX5-AU,551,2200.35,300,1713.65,851,3914.00,20150401
CGG_GM11-AU,156,594.90,91,418.10,247,1013.00,20150401
CGG_GM16-AU,167,469.50,59,260.60,226,730.10,20150401
CGG_HAY1-AU,237,1918.10,648,5680.10,885,7598.20,20150401
CGG_HAY2-AU,356,2640.10,827,7341.60,1183,9981.70,20150401
CGG_HAY3-AU,859,5089.75,1100,9518.85,1959,14608.60,20150401
CGG_JSX1-AU,1098,2241.30,143,463.55,1241,2704.85,20150401
CGG_JSX2-AU,923,2047.15,153,559.80,1076,2606.95,20150401
CGG_LM11-AU,702,1428.05,106,404.85,808,1832.90,20150401
CGG_LM12-AU,573,906.20,27,82.40,600,988.60,20150401
CGG_LM13-AU,0,0.00,0,0.00,0,0.00,20150401
CGG_LM14-AU,191,250.70,13,36.20,204,286.90,20150401
CGG_LM15-AU,365,692.80,65,244.85,430,937.65,20150401
CGG_LM16-AU,772,1508.60,134,475.50,906,1984.10,20150401
CGG_LM30-AU,898,1544.10,91,256.00,989,1800.10,20150401
CGG_LM32-AU,1291,2100.15,115,339.75,1406,2439.90,20150401
CGG_LM41-AU,1121,1871.70,73,205.40,1194,2077.10,20150401
CGG_LM42-AU,985,1606.30,82,215.95,1067,1822.25,20150401
CGG_LM43-AU,1575,1987.90,91,223.20,1666,2211.10,20150401
CGG_LM44-AU,1742,2717.55,126,353.35,1868,3070.90,20150401
CGG_LMX2-AU,191,995.20,164,2142.50,355,3137.70,20150401
CGG_LR11-AU,884,1907.40,68,195.50,952,2102.90,20150401
CGG_LR12-AU,1294,2673.75,113,354.90,1407,3028.65,20150401
CGG_LR13-AU,2103,4495.95,147,465.50,2250,4961.45,20150401
CGG_LR14-AU,907,1875.20,88,264.90,995,2140.10,20150401
CGG_LR15-AU,890,2079.05,151,512.95,1041,2592.00,20150401
CGG_LR16-AU,948,2200.20,155,548.70,1103,2748.90,20150401
CGG_LR31-AU,346,1023.50,60,313.70,406,1337.20,20150401
CGG_LR33-AU,501,1583.55,115,628.05,616,2211.60,20150401
CGG_LR43-AU,725,2025.15,84,361.25,809,2386.40,20150401
CGG_LR47-AU,1170,3553.20,179,789.70,1349,4342.90,20150401
CGG_MB11-AU,758,1672.80,68,239.30,826,1912.10,20150401
CGG_MB12-AU,1213,2472.75,134,448.60,1347,2921.35,20150401
CGG_MB13-AU,764,1535.35,67,231.75,831,1767.10,20150401
CGG_MB14-AU,781,1505.30,84,280.55,865,1785.85,20150401
CGG_MB15-AU,480,876.10,58,193.00,538,1069.10,20150401
CGG_MB16-AU,758,1393.05,83,261.10,841,1654.15,20150401
CGG_MB17-AU,1031,1899.70,112,369.10,1143,2268.80,20150401
CGG_MB23-AU,1381,2303.50,138,387.80,1519,2691.30,20150401
CGG_MB31-AU,1900,3019.10,124,360.15,2024,3379.25,20150401
CGG_MB32-AU,1929,2688.75,108,276.40,2037,2965.15,20150401
CGG_MB33-AU,1679,2934.30,127,368.30,1806,3302.60,20150401
CGG_MB34-AU,1765,2534.95,83,202.75,1848,2737.70,20150401
CGG_MB35-AU,1254,2580.50,146,539.20,1400,3119.70,20150401
CGG_MB36-AU,2191,3369.75,153,476.60,2344,3846.35,20150401
CGG_MB37-AU,1147,2085.35,110,360.35,1257,2445.70,20150401
CGG_MB38-AU,1722,2852.80,79,191.50,1801,3044.30,20150401
CGG_MB41-AU,1417,2529.25,125,354.45,1542,2883.70,20150401
CGG_MB42-AU,990,2453.05,65,238.05,1055,2691.10,20150401
CGG_MB44-AU,976,2065.40,69,222.25,1045,2287.65,20150401
CGG_MBX1-AU,1179,3217.85,230,874.90,1409,4092.75,20150401
CGG_MBX2-AU,998,2648.70,198,738.60,1196,3387.30,20150401
CGG_MBX4-AU,611,1559.25,143,551.10,754,2110.35,20150401
CGG_MC21-AU,1403,3611.00,161,1071.85,1564,4682.85,20150401
CGG_MC22-AU,1451,3581.70,159,819.20,1610,4400.90,20150401
CGG_MC23-AU,832,2070.00,89,369.80,921,2439.80,20150401
CGG_MC31-AU,628,1509.65,123,584.15,751,2093.80,20150401
CGG_MC32-AU,249,781.35,67,426.15,316,1207.50,20150401
CGG_MC33-AU,355,1171.00,95,619.30,450,1790.30,20150401
CGG_MK31-AU,227,817.75,94,503.05,321,1320.80,20150401
CGG_MK34-AU,185,557.85,68,363.10,253,920.95,20150401
CGG_MK35-AU,117,387.95,26,152.50,143,540.45,20150401
CGG_MM41-AU,2016,3506.25,141,395.85,2157,3902.10,20150401
CGG_MS10-AU,437,816.85,50,181.20,487,998.05,20150401
CGG_MS11-AU,1058,2146.90,143,469.80,1201,2616.70,20150401
CGG_MS12-AU,1579,2518.50,165,500.85,1744,3019.35,20150401
CGG_MS21-AU,1621,2814.10,144,462.85,1765,3276.95,20150401
CGG_MS30-AU,611,1073.50,52,146.75,663,1220.25,20150401
CGG_MS31-AU,2065,4041.50,223,639.40,2288,4680.90,20150401
CGG_MS32-AU,1338,2328.20,139,377.15,1477,2705.35,20150401
CGG_MS41-AU,925,1713.90,88,247.85,1013,1961.75,20150401
CGG_MS42-AU,1765,2351.10,162,324.55,1927,2675.65,20150401
CGG_MS43-AU,1665,2875.40,113,280.85,1778,3156.25,20150401
CGG_MS44-AU,1560,2265.35,75,167.15,1635,2432.50,20150401
CGG_MS46-AU,1389,1974.10,71,185.50,1460,2159.60,20150401
CGG_MY21-AU,963,1997.55,69,227.40,1032,2224.95,20150401
CGG_MY22-AU,1004,2396.90,74,255.50,1078,2652.40,20150401
CGG_MY23-AU,759,1688.60,64,202.40,823,1891.00,20150401
CGG_MY24-AU,837,2034.75,73,247.40,910,2282.15,20150401
CGG_MY25-AU,968,2116.90,87,304.95,1055,2421.85,20150401
CGG_MY26-AU,1000,2396.45,93,294.80,1093,2691.25,20150401
CGG_MY31-AU,495,1180.65,66,261.20,561,1441.85,20150401
CGG_MY32-AU,510,1260.55,55,233.10,565,1493.65,20150401
CGG_MY33-AU,323,846.00,73,296.25,396,1142.25,20150401
CGG_MY34-AU,344,1085.45,38,144.25,382,1229.70,20150401
CGG_MY35-AU,268,772.35,23,84.35,291,856.70,20150401
CGG_MY41-AU,1726,3704.30,161,511.60,1887,4215.90,20150401
CGG_MY42-AU,2214,4310.80,182,547.30,2396,4858.10,20150401
CGG_MY43-AU,813,2388.50,71,274.95,884,2663.45,20150401
CGG_MY44-AU,454,1334.40,52,197.45,506,1531.85,20150401
CGG_MY45-AU,856,2653.70,110,464.95,966,3118.65,20150401
CGG_MY46-AU,1680,5172.40,214,863.70,1894,6036.10,20150401
CGG_MY47-AU,1194,3646.45,161,631.15,1355,4277.60,20150401
CGG_MY51-AU,889,3092.80,157,830.50,1046,3923.30,20150401
CGG_MY52-AU,689,2575.65,307,2233.60,996,4809.25,20150401
CGG_MY53-AU,640,2321.05,129,696.80,769,3017.85,20150401
CGG_MY54-AU,817,3359.70,250,1821.05,1067,5180.75,20150401
CGG_MY55-AU,963,3386.35,203,1063.60,1166,4449.95,20150401
CGG_MY56-AU,978,4145.90,316,2247.85,1294,6393.75,20150401
CGG_MY57-AU,953,3505.80,207,1112.35,1160,4618.15,20150401
CGG_PNR1-AU,745,2267.15,450,1350.00,1195,3617.15,20150401
CGG_PNR2-AU,40,121.20,16,48.00,56,169.20,20150401
CGG_RBX4-AU,230,700.30,50,225.60,280,925.90,20150401
CGG_RBX5-AU,191,877.85,100,497.50,291,1375.35,20150401
CGG_RBX6-AU,334,1610.85,342,1691.20,676,3302.05,20150401
CGG_RBX7-AU,242,1114.30,222,1096.85,464,2211.15,20150401
CGG_RS11-AU,605,1055.45,33,101.80,638,1157.25,20150401
CGG_RS13-AU,455,709.35,43,146.80,498,856.15,20150401
CGG_RS14-AU,1244,1496.20,58,137.85,1302,1634.05,20150401
CGG_RS15-AU,643,1213.50,80,262.95,723,1476.45,20150401
CGG_RS16-AU,1210,1815.15,75,226.55,1285,2041.70,20150401
CGG_RS20-AU,1418,2118.80,99,266.60,1517,2385.40,20150401
CGG_RS21-AU,1385,2303.35,142,387.75,1527,2691.10,20150401
CGG_RS22-AU,2397,3653.50,163,450.10,2560,4103.60,20150401
CGG_RS23-AU,1702,2879.15,151,485.85,1853,3365.00,20150401
CGG_RS30-AU,1320,2428.60,129,438.50,1449,2867.10,20150401
CGG_RS31-AU,1241,2538.90,202,749.80,1443,3288.70,20150401
CGG_RS32-AU,751,1546.70,77,265.50,828,1812.20,20150401
CGG_RS33-AU,1095,2041.55,133,435.45,1228,2477.00,20150401
CGG_RS41-AU,1146,2254.40,169,545.90,1315,2800.30,20150401
CGG_RS42-AU,1278,3035.85,166,563.50,1444,3599.35,20150401
CGG_RS43-AU,680,1458.95,86,262.40,766,1721.35,20150401
CGG_RS44-AU,496,1211.05,62,206.15,558,1417.20,20150401
CGG_RS45-AU,1268,2636.85,120,374.85,1388,3011.70,20150401
CGG_RS46-AU,833,2073.20,85,264.25,918,2337.45,20150401
CGG_RS50-AU,417,885.10,34,74.25,451,959.35,20150401
CGG_RS53-AU,820,2019.25,120,444.30,940,2463.55,20150401
CGG_RSX1-AU,449,598.50,28,82.90,477,681.40,20150401
CGG_RSX2-AU,574,1081.70,44,139.85,618,1221.55,20150401
CGG_RSX3-AU,506,1033.35,23,87.45,529,1120.80,20150401
CGG_RT12-AU,1028,2823.25,148,709.05,1176,3532.30,20150401
CGG_SS31-AU,723,1527.80,61,228.00,784,1755.80,20150401
CGG_SS32-AU,617,1242.80,56,213.00,673,1455.80,20150401
CGG_SW30-AU,389,1487.95,93,783.70,482,2271.65,20150401
CGG_SW31-AU,1136,3226.25,144,574.90,1280,3801.15,20150401
CGG_SW32-AU,397,1449.00,147,1341.15,544,2790.15,20150401
CGG_SW33-AU,583,1707.45,70,290.00,653,1997.45,20150401
CGG_SW34-AU,628,2498.25,209,1858.05,837,4356.30,20150401
CGG_SW35-AU,641,1979.65,108,431.80,749,2411.45,20150401
CGG_TM10-AU,1839,4945.30,533,2309.50,2372,7254.80,20150401
CGG_TMX3-AU,897,3059.25,291,2026.15,1188,5085.40,20150401
CGG_TMX4-AU,1408,4713.50,328,2231.80,1736,6945.30,20150401
CGG_TMX5-AU,1460,4635.85,614,4506.05,2074,9141.90,20150401
CGG_TMX6-AU,1403,4914.05,537,3903.00,1940,8817.05,20150401
CGG_TMX7-AU,1470,4116.70,455,2050.40,1925,6167.10,20150401
CGG_TMX8-AU,2064,6069.60,1284,6055.40,3348,12125.00,20150401
CGG_TMX9-AU,2128,5710.55,652,2810.80,2780,8521.35,20150401
CGG_TPX1-AU,766,1868.25,145,545.50,911,2413.75,20150401
CGG_US10-AU,1046,1889.30,105,296.00,1151,2185.30,20150401
CGG_WB11-AU,53,277.10,136,815.00,189,1092.10,20150401
CGG_WB12-AU,108,510.20,75,389.95,183,900.15,20150401
CGG_WB13-AU,48,262.70,127,758.50,175,1021.20,20150401
CGG_WB14-AU,151,645.75,83,426.95,234,1072.70,20150401
CGG_WB15-AU,105,529.90,128,756.50,233,1286.40,20150401
CGG_WB16-AU,191,810.60,166,878.60,357,1689.20,20150401
CGG_WBF1-AU,407,1249.00,121,592.35,528,1841.35,20150401
CGG_WBF2-AU,315,1059.40,105,568.05,420,1627.45,20150401
CGG_WES1-AU,392,1688.50,108,681.10,500,2369.60,20150401
CGG_WES2-AU,653,2899.30,262,1801.70,915,4701.00,20150401
CGG_YA11-AU,703,1445.15,77,236.70,780,1681.85,20150401
CGG_YA13-AU,1664,3107.40,134,380.25,1798,3487.65,20150401
CGG_YA14-AU,979,1802.40,96,258.50,1075,2060.90,20150401
CGG_YA18-AU,978,1968.90,101,297.40,1079,2266.30,20150401
CGG_YA20-AU,1379,2877.45,149,484.80,1528,3362.25,20150401
CGG_YA21-AU,984,1833.20,87,255.45,1071,2088.65,20150401
CGG_YA23-AU,883,1826.90,81,259.15,964,2086.05,20150401
CGG_YA31-AU,1454,3506.00,178,647.35,1632,4153.35,20150401
CGG_YA32-AU,1010,2322.65,98,344.30,1108,2666.95,20150401
CGG_YA34-AU,813,2267.80,157,798.55,970,3066.35,20150401
CGG_YA35-AU,995,2978.70,148,775.55,1143,3754.25,20150401
CGG_YA36-AU,681,1833.10,139,715.45,820,2548.55,20150401
CGG_YAX1-AU,706,2226.55,124,563.50,830,2790.05,20150401
CGG_YAX2-AU,541,1595.45,76,286.00,617,1881.45,20150401
CGG_YAX3-AU,231,743.50,56,269.35,287,1012.85,20150401
CGG_YAX4-AU,336,953.80,68,349.35,404,1303.15,20150401
CGG_YCX1-AU,311,759.45,51,277.45,362,1036.90,20150401
CGG_AP21-AU,433,1040.55,70,266.85,503,1307.40,20150301
CGG_BC13-AU,97,510.35,98,582.60,195,1092.95,20150301
CGG_BC14-AU,102,473.65,145,852.10,247,1325.75,20150301
CGG_BC21-AU,194,867.30,217,2569.95,411,3437.25,20150301
CGG_BC41-AU,228,930.35,171,983.50,399,1913.85,20150301
CGG_BC42-AU,121,497.90,41,239.25,162,737.15,20150301
CGG_BC43-AU,184,676.65,295,1750.60,479,2427.25,20150301
CGG_BR14-AU,145,419.65,51,232.50,196,652.15,20150301
CGG_BR15-AU,241,787.60,137,614.90,378,1402.50,20150301
CGG_BR16-AU,217,619.10,84,384.35,301,1003.45,20150301
CGG_BR22-AU,539,1447.70,121,449.90,660,1897.60,20150301
CGG_BR23-AU,544,1571.70,253,1378.60,797,2950.30,20150301
CGG_BR26-AU,640,1448.45,172,661.75,812,2110.20,20150301
CGG_BR31-AU,758,2005.00,159,782.25,917,2787.25,20150301
CGG_BR32-AU,725,1599.55,62,201.75,787,1801.30,20150301
CGG_BR33-AU,298,720.95,41,166.10,339,887.05,20150301
CGG_BR34-AU,1274,2473.25,119,377.25,1393,2850.50,20150301
CGG_BR35-AU,755,1885.85,125,569.30,880,2455.15,20150301
CGG_BR41-AU,123,499.35,155,920.00,278,1419.35,20150301
CGG_BR42-AU,595,1477.45,144,590.50,739,2067.95,20150301
CGG_BR43-AU,101,413.20,135,801.75,236,1214.95,20150301
CGG_BR44-AU,234,592.35,43,172.45,277,764.80,20150301
CGG_BR45-AU,88,403.05,124,741.75,212,1144.80,20150301
CGG_BS11-AU,137,726.35,173,1025.60,310,1751.95,20150301
CGG_BS12-AU,337,988.25,70,336.15,407,1324.40,20150301
CGG_BS13-AU,89,512.70,191,1142.50,280,1655.20,20150301
CGG_BS16-AU,99,470.00,133,777.05,232,1247.05,20150301
CGG_BS17-AU,436,1301.80,85,669.90,521,1971.70,20150301
CGG_BS18-AU,473,1347.40,106,489.75,579,1837.15,20150301
CGG_BS21-AU,1307,3062.40,130,449.10,1437,3511.50,20150301
CGG_BS22-AU,905,1803.70,60,199.90,965,2003.60,20150301
CGG_BS23-AU,939,2194.35,132,451.65,1071,2646.00,20150301
CGG_BS24-AU,1016,2178.80,113,341.70,1129,2520.50,20150301
CGG_BS25-AU,1124,2692.10,164,545.40,1288,3237.50,20150301
CGG_BS26-AU,1714,3991.45,237,778.80,1951,4770.25,20150301
CGG_BS27-AU,2042,5375.90,277,992.85,2319,6368.75,20150301
CGG_BS29-AU,830,2437.90,99,389.85,929,2827.75,20150301
CGG_BS31-AU,671,1913.40,78,333.70,749,2247.10,20150301
CGG_BS32-AU,991,2825.45,123,458.60,1114,3284.05,20150301
CGG_BS34-AU,129,371.45,18,65.60,147,437.05,20150301
CGG_BS35-AU,624,1859.95,77,296.15,701,2156.10,20150301
CGG_BS36-AU,1768,5186.65,224,836.70,1992,6023.35,20150301
CGG_BS37-AU,1694,4929.55,206,817.25,1900,5746.80,20150301
CGG_BS51-AU,497,1846.75,126,703.00,623,2549.75,20150301
CGG_BS52-AU,328,1263.15,73,408.05,401,1671.20,20150301
CGG_BS53-AU,625,2424.25,132,758.05,757,3182.30,20150301
CGG_BS54-AU,610,2353.05,125,648.65,735,3001.70,20150301
CGG_CCX1-AU,123,704.25,206,2894.90,329,3599.15,20150301
CGG_CCX2-AU,194,1303.50,181,2271.70,375,3575.20,20150301
CGG_CCX3-AU,40,198.85,43,568.70,83,767.55,20150301
CGG_CCX4-AU,23,128.65,49,610.00,72,738.65,20150301
CGG_CCX5-AU,217,1610.15,207,2938.00,424,4548.15,20150301
CGG_CCX6-AU,36,258.50,81,1258.10,117,1516.60,20150301
CGG_CL11-AU,677,1696.85,140,548.60,817,2245.45,20150301
CGG_CLX2-AU,890,1972.90,106,376.80,996,2349.70,20150301
CGG_CPX1-AU,1756,5825.00,442,2412.25,2198,8237.25,20150301
CGG_CPX2-AU,1095,3749.95,324,1733.45,1419,5483.40,20150301
CGG_CS21-AU,746,2399.75,232,1347.35,978,3747.10,20150301
CGG_CS22-AU,624,1467.75,97,331.00,721,1798.75,20150301
CGG_CUX2-AU,291,722.70,117,484.35,408,1207.05,20150301
CGG_EB29-AU,423,1324.15,94,469.95,517,1794.10,20150301
CGG_EB31-AU,585,1684.10,93,410.60,678,2094.70,20150301
CGG_EB32-AU,681,1794.20,118,553.00,799,2347.20,20150301
CGG_EB33-AU,1194,3221.25,176,799.90,1370,4021.15,20150301
CGG_EB34-AU,477,1156.20,61,263.10,538,1419.30,20150301
CGG_EB35-AU,1055,3113.70,160,707.35,1215,3821.05,20150301
CGG_EB36-AU,1069,3010.80,174,773.65,1243,3784.45,20150301
CGG_EB41-AU,660,2035.30,159,1239.90,819,3275.20,20150301
CGG_EB42-AU,160,745.45,79,461.25,239,1206.70,20150301
CGG_EB44-AU,92,361.35,159,948.25,251,1309.60,20150301
CGG_EB46-AU,89,352.05,114,670.75,203,1022.80,20150301
CGG_FM21-AU,517,2227.90,289,3096.80,806,5324.70,20150301
CGG_FM22-AU,259,1109.30,323,4214.25,582,5323.55,20150301
CGG_FM23-AU,346,1283.90,276,3579.25,622,4863.15,20150301
CGG_FM24-AU,294,1309.35,245,3253.55,539,4562.90,20150301
CGG_FS21-AU,275,1110.25,116,1370.50,391,2480.75,20150301
CGG_FS22-AU,269,876.00,76,344.20,345,1220.20,20150301
CGG_FS23-AU,110,395.30,113,1512.45,223,1907.75,20150301
CGG_FS24-AU,318,964.95,94,506.85,412,1471.80,20150301
CGG_FS25-AU,350,1065.70,107,584.90,457,1650.60,20150301
CGG_FS26-AU,323,1046.30,102,601.80,425,1648.10,20150301
CGG_FS31-AU,841,1884.15,91,326.80,932,2210.95,20150301
CGG_FS32-AU,988,2354.95,153,549.20,1141,2904.15,20150301
CGG_FS33-AU,1596,3198.45,146,480.30,1742,3678.75,20150301
CGG_GC13-AU,168,836.85,162,929.80,330,1766.65,20150301
CGG_GH11-AU,160,490.10,51,215.60,211,705.70,20150301
CGG_GH15-AU,163,509.60,88,403.75,251,913.35,20150301
CGG_GH21-AU,427,851.50,54,186.20,481,1037.70,20150301
CGG_GH23-AU,854,1581.50,128,443.60,982,2025.10,20150301
CGG_GH24-AU,1367,2783.60,218,757.20,1585,3540.80,20150301
CGG_GH31-AU,1399,2581.80,154,493.35,1553,3075.15,20150301
CGG_GH32-AU,1070,2078.95,138,455.45,1208,2534.40,20150301
CGG_GH33-AU,784,1956.20,76,334.75,860,2290.95,20150301
CGG_GH34-AU,925,2239.00,80,266.20,1005,2505.20,20150301
CGG_GH36-AU,1318,3157.80,106,404.95,1424,3562.75,20150301
CGG_GHX1-AU,1088,3701.65,367,2033.55,1455,5735.20,20150301
CGG_GHX3-AU,678,2205.05,300,1638.60,978,3843.65,20150301
CGG_GHX5-AU,700,2497.30,319,1880.55,1019,4377.85,20150301
CGG_GM11-AU,160,595.20,73,341.85,233,937.05,20150301
CGG_GM16-AU,142,455.70,76,343.10,218,798.80,20150301
CGG_HAY1-AU,254,1983.70,722,6424.30,976,8408.00,20150301
CGG_HAY2-AU,357,2682.65,881,7809.00,1238,10491.65,20150301
CGG_HAY3-AU,950,5404.75,1275,10932.85,2225,16337.60,20150301
CGG_JSX1-AU,930,2071.50,123,456.75,1053,2528.25,20150301
CGG_JSX2-AU,980,2163.10,199,769.90,1179,2933.00,20150301
CGG_LM11-AU,731,1437.65,110,418.05,841,1855.70,20150301
CGG_LM12-AU,766,1262.40,64,193.00,830,1455.40,20150301
CGG_LM13-AU,0,0.00,0,0.00,0,0.00,20150301
CGG_LM14-AU,348,607.20,40,144.90,388,752.10,20150301
CGG_LM15-AU,436,893.50,80,293.00,516,1186.50,20150301
CGG_LM16-AU,779,1617.95,137,512.30,916,2130.25,20150301
CGG_LM30-AU,895,1522.05,61,186.75,956,1708.80,20150301
CGG_LM32-AU,1402,2236.60,94,239.75,1496,2476.35,20150301
CGG_LM41-AU,1052,1710.20,91,245.25,1143,1955.45,20150301
CGG_LM42-AU,924,1544.70,81,224.25,1005,1768.95,20150301
CGG_LM43-AU,1498,1911.75,66,148.95,1564,2060.70,20150301
CGG_LM44-AU,1779,2773.15,115,327.25,1894,3100.40,20150301
CGG_LMX2-AU,267,1459.00,206,2425.60,473,3884.60,20150301
CGG_LR11-AU,839,1872.50,70,218.10,909,2090.60,20150301
CGG_LR12-AU,1277,2587.70,119,364.75,1396,2952.45,20150301
CGG_LR13-AU,2164,4673.50,169,518.00,2333,5191.50,20150301
CGG_LR14-AU,891,1850.50,70,241.20,961,2091.70,20150301
CGG_LR15-AU,927,2238.50,137,460.45,1064,2698.95,20150301
CGG_LR16-AU,984,2254.70,147,487.40,1131,2742.10,20150301
CGG_LR31-AU,295,879.95,58,313.10,353,1193.05,20150301
CGG_LR33-AU,456,1345.45,103,580.55,559,1926.00,20150301
CGG_LR43-AU,789,2224.45,93,341.15,882,2565.60,20150301
CGG_LR47-AU,1150,3387.45,153,749.90,1303,4137.35,20150301
CGG_MB11-AU,725,1630.55,58,180.50,783,1811.05,20150301
CGG_MB12-AU,1190,2478.00,133,448.55,1323,2926.55,20150301
CGG_MB13-AU,702,1416.40,57,184.95,759,1601.35,20150301
CGG_MB14-AU,837,1553.95,74,247.40,911,1801.35,20150301
CGG_MB15-AU,587,1039.45,52,152.95,639,1192.40,20150301
CGG_MB16-AU,779,1428.80,74,233.65,853,1662.45,20150301
CGG_MB17-AU,981,1638.90,127,439.70,1108,2078.60,20150301
CGG_MB23-AU,1392,2261.00,84,242.25,1476,2503.25,20150301
CGG_MB31-AU,1770,2793.55,108,304.00,1878,3097.55,20150301
CGG_MB32-AU,1705,2463.70,84,202.65,1789,2666.35,20150301
CGG_MB33-AU,1747,2949.70,103,289.20,1850,3238.90,20150301
CGG_MB34-AU,1446,2142.80,85,222.95,1531,2365.75,20150301
CGG_MB35-AU,1082,2257.75,131,484.20,1213,2741.95,20150301
CGG_MB36-AU,2074,3294.40,129,394.65,2203,3689.05,20150301
CGG_MB37-AU,969,1847.85,129,450.40,1098,2298.25,20150301
CGG_MB38-AU,1550,2502.80,78,205.40,1628,2708.20,20150301
CGG_MB41-AU,1518,2727.75,110,342.10,1628,3069.85,20150301
CGG_MB42-AU,1070,2647.35,68,235.55,1138,2882.90,20150301
CGG_MB44-AU,1058,2323.15,90,308.55,1148,2631.70,20150301
CGG_MBX1-AU,1222,3221.60,237,878.40,1459,4100.00,20150301
CGG_MBX2-AU,969,2526.45,202,722.40,1171,3248.85,20150301
CGG_MBX4-AU,761,1917.70,159,597.40,920,2515.10,20150301
CGG_MC21-AU,1529,3921.05,135,814.85,1664,4735.90,20150301
CGG_MC22-AU,1481,3626.15,156,849.65,1637,4475.80,20150301
CGG_MC23-AU,801,2041.30,82,444.90,883,2486.20,20150301
CGG_MC31-AU,684,1505.10,111,677.30,795,2182.40,20150301
CGG_MC32-AU,336,1047.35,48,284.95,384,1332.30,20150301
CGG_MC33-AU,357,1220.50,105,714.25,462,1934.75,20150301
CGG_MK31-AU,196,638.40,69,352.50,265,990.90,20150301
CGG_MK34-AU,188,486.50,61,293.70,249,780.20,20150301
CGG_MK35-AU,120,314.00,31,171.85,151,485.85,20150301
CGG_MM41-AU,1886,3288.10,128,342.75,2014,3630.85,20150301
CGG_MS10-AU,411,781.65,61,232.45,472,1014.10,20150301
CGG_MS11-AU,1060,2038.65,118,373.45,1178,2412.10,20150301
CGG_MS12-AU,1582,2508.50,149,445.00,1731,2953.50,20150301
CGG_MS21-AU,1549,2592.70,176,527.10,1725,3119.80,20150301
CGG_MS30-AU,677,1098.65,53,146.15,730,1244.80,20150301
CGG_MS31-AU,1951,3822.00,241,689.40,2192,4511.40,20150301
CGG_MS32-AU,1383,2366.85,128,349.70,1511,2716.55,20150301
CGG_MS41-AU,934,1585.55,79,209.20,1013,1794.75,20150301
CGG_MS42-AU,1685,2259.30,201,412.15,1886,2671.45,20150301
CGG_MS43-AU,1661,2819.45,137,348.95,1798,3168.40,20150301
CGG_MS44-AU,1458,2153.80,103,207.60,1561,2361.40,20150301
CGG_MS46-AU,1237,1828.20,73,180.35,1310,2008.55,20150301
CGG_MY21-AU,1045,2174.50,85,288.00,1130,2462.50,20150301
CGG_MY22-AU,1024,2454.60,99,355.45,1123,2810.05,20150301
CGG_MY23-AU,786,1718.15,58,173.60,844,1891.75,20150301
CGG_MY24-AU,856,1953.75,72,248.00,928,2201.75,20150301
CGG_MY25-AU,1055,2286.70,77,249.85,1132,2536.55,20150301
CGG_MY26-AU,951,2269.25,102,366.20,1053,2635.45,20150301
CGG_MY31-AU,469,1161.90,69,265.60,538,1427.50,20150301
CGG_MY32-AU,543,1372.15,74,268.55,617,1640.70,20150301
CGG_MY33-AU,286,778.20,69,288.10,355,1066.30,20150301
CGG_MY34-AU,339,944.10,42,165.60,381,1109.70,20150301
CGG_MY35-AU,213,578.80,38,135.60,251,714.40,20150301
CGG_MY41-AU,1646,3532.90,174,544.60,1820,4077.50,20150301
CGG_MY42-AU,2221,4518.95,158,477.95,2379,4996.90,20150301
CGG_MY43-AU,898,2645.65,91,353.10,989,2998.75,20150301
CGG_MY44-AU,466,1410.30,54,209.95,520,1620.25,20150301
CGG_MY45-AU,837,2560.55,138,539.95,975,3100.50,20150301
CGG_MY46-AU,1643,5155.05,223,890.55,1866,6045.60,20150301
CGG_MY47-AU,1115,3435.35,191,759.30,1306,4194.65,20150301
CGG_MY51-AU,835,2818.10,173,862.35,1008,3680.45,20150301
CGG_MY52-AU,794,3048.65,297,2174.25,1091,5222.90,20150301
CGG_MY53-AU,666,2254.65,127,705.55,793,2960.20,20150301
CGG_MY54-AU,801,3262.35,255,1799.20,1056,5061.55,20150301
CGG_MY55-AU,980,3537.65,194,973.00,1174,4510.65,20150301
CGG_MY56-AU,980,4156.00,301,2165.45,1281,6321.45,20150301
CGG_MY57-AU,920,3352.25,205,1092.40,1125,4444.65,20150301
CGG_PNR1-AU,798,2410.85,338,1014.00,1136,3424.85,20150301
CGG_PNR2-AU,34,103.10,26,78.00,60,181.10,20150301
CGG_RBX4-AU,221,661.55,40,167.45,261,829.00,20150301
CGG_RBX5-AU,170,807.05,130,643.75,300,1450.80,20150301
CGG_RBX6-AU,322,1524.65,375,1852.40,697,3377.05,20150301
CGG_RBX7-AU,267,1162.65,222,1074.85,489,2237.50,20150301
CGG_RS11-AU,567,968.70,53,180.55,620,1149.25,20150301
CGG_RS13-AU,453,730.65,44,156.20,497,886.85,20150301
CGG_RS14-AU,1294,1555.65,48,120.45,1342,1676.10,20150301
CGG_RS15-AU,612,1170.60,97,309.90,709,1480.50,20150301
CGG_RS16-AU,1173,1839.80,82,251.55,1255,2091.35,20150301
CGG_RS20-AU,1367,2018.85,103,250.75,1470,2269.60,20150301
CGG_RS21-AU,1407,2319.55,131,380.85,1538,2700.40,20150301
CGG_RS22-AU,2224,3402.60,135,316.55,2359,3719.15,20150301
CGG_RS23-AU,1736,2973.00,203,608.90,1939,3581.90,20150301
CGG_RS30-AU,1378,2371.55,104,255.70,1482,2627.25,20150301
CGG_RS31-AU,1377,2610.75,165,563.45,1542,3174.20,20150301
CGG_RS32-AU,716,1518.65,65,211.80,781,1730.45,20150301
CGG_RS33-AU,862,1641.40,161,558.50,1023,2199.90,20150301
CGG_RS41-AU,1216,2463.35,181,614.15,1397,3077.50,20150301
CGG_RS42-AU,1265,3050.90,145,513.60,1410,3564.50,20150301
CGG_RS43-AU,370,762.10,51,159.35,421,921.45,20150301
CGG_RS44-AU,512,1202.15,52,195.60,564,1397.75,20150301
CGG_RS45-AU,1468,3067.35,177,583.50,1645,3650.85,20150301
CGG_RS46-AU,799,1987.40,102,346.75,901,2334.15,20150301
CGG_RS50-AU,427,871.45,31,67.40,458,938.85,20150301
CGG_RS53-AU,775,1940.25,137,536.80,912,2477.05,20150301
CGG_RSX1-AU,419,542.05,24,90.55,443,632.60,20150301
CGG_RSX2-AU,598,1156.10,49,163.05,647,1319.15,20150301
CGG_RSX3-AU,466,920.30,33,131.85,499,1052.15,20150301
CGG_RT12-AU,1031,2819.45,131,652.25,1162,3471.70,20150301
CGG_SS31-AU,736,1643.60,74,312.35,810,1955.95,20150301
CGG_SS32-AU,618,1335.75,55,219.30,673,1555.05,20150301
CGG_SW30-AU,350,1213.45,120,951.20,470,2164.65,20150301
CGG_SW31-AU,1049,2954.00,169,673.65,1218,3627.65,20150301
CGG_SW32-AU,278,966.85,150,1350.55,428,2317.40,20150301
CGG_SW33-AU,624,1847.30,99,388.70,723,2236.00,20150301
CGG_SW34-AU,670,2720.70,233,2106.10,903,4826.80,20150301
CGG_SW35-AU,731,2243.20,115,459.25,846,2702.45,20150301
CGG_TM10-AU,1627,4386.90,465,2060.45,2092,6447.35,20150301
CGG_TMX3-AU,964,3377.25,302,2102.35,1266,5479.60,20150301
CGG_TMX4-AU,1173,3835.40,348,2215.90,1521,6051.30,20150301
CGG_TMX5-AU,1427,4407.60,626,4682.35,2053,9089.95,20150301
CGG_TMX6-AU,1492,5262.15,561,3999.00,2053,9261.15,20150301
CGG_TMX7-AU,1210,3534.55,536,2398.55,1746,5933.10,20150301
CGG_TMX8-AU,1912,5836.85,1284,6090.35,3196,11927.20,20150301
CGG_TMX9-AU,2406,6615.65,572,2455.20,2978,9070.85,20150301
CGG_TPX1-AU,724,1538.45,185,715.50,909,2253.95,20150301
CGG_US10-AU,976,1806.25,122,387.90,1098,2194.15,20150301
CGG_WB11-AU,62,353.40,130,762.80,192,1116.20,20150301
CGG_WB12-AU,96,453.35,72,374.10,168,827.45,20150301
CGG_WB13-AU,47,275.30,114,677.60,161,952.90,20150301
CGG_WB14-AU,140,619.75,77,415.50,217,1035.25,20150301
CGG_WB15-AU,68,356.00,150,886.35,218,1242.35,20150301
CGG_WB16-AU,186,811.25,153,798.80,339,1610.05,20150301
CGG_WBF1-AU,355,1036.20,72,358.65,427,1394.85,20150301
CGG_WBF2-AU,218,717.35,72,379.35,290,1096.70,20150301
CGG_WES1-AU,319,1379.50,78,561.85,397,1941.35,20150301
CGG_WES2-AU,524,2202.15,222,1492.30,746,3694.45,20150301
CGG_YA11-AU,703,1416.80,47,140.50,750,1557.30,20150301
CGG_YA13-AU,1736,3105.80,144,407.75,1880,3513.55,20150301
CGG_YA14-AU,991,1754.30,98,278.40,1089,2032.70,20150301
CGG_YA18-AU,933,1763.30,108,316.65,1041,2079.95,20150301
CGG_YA20-AU,1348,2720.20,133,445.50,1481,3165.70,20150301
CGG_YA21-AU,958,1776.10,95,267.85,1053,2043.95,20150301
CGG_YA23-AU,913,1848.50,96,299.20,1009,2147.70,20150301
CGG_YA31-AU,1478,3568.45,171,547.15,1649,4115.60,20150301
CGG_YA32-AU,1031,2329.85,99,321.70,1130,2651.55,20150301
CGG_YA34-AU,842,2318.50,128,656.85,970,2975.35,20150301
CGG_YA35-AU,955,2854.65,155,834.25,1110,3688.90,20150301
CGG_YA36-AU,644,1766.55,113,595.50,757,2362.05,20150301
CGG_YAX1-AU,714,2122.20,114,534.20,828,2656.40,20150301
CGG_YAX2-AU,548,1597.90,87,381.80,635,1979.70,20150301
CGG_YAX3-AU,237,741.90,44,231.85,281,973.75,20150301
CGG_YAX4-AU,316,856.40,74,386.80,390,1243.20,20150301
CGG_YCX1-AU,331,854.60,44,225.00,375,1079.60,20150301
CGG_AP21-AU,582,1339.40,76,259.20,658,1598.60,20150201
CGG_BC13-AU,86,482.40,121,718.00,207,1200.40,20150201
CGG_BC14-AU,82,376.90,144,852.85,226,1229.75,20150201
CGG_BC21-AU,206,800.95,199,2729.90,405,3530.85,20150201
CGG_BC41-AU,277,1071.60,181,1047.45,458,2119.05,20150201
CGG_BC42-AU,98,396.15,66,366.30,164,762.45,20150201
CGG_BC43-AU,179,685.40,307,1821.35,486,2506.75,20150201
CGG_BR14-AU,111,317.75,24,101.25,135,419.00,20150201
CGG_BR15-AU,203,601.80,80,362.45,283,964.25,20150201
CGG_BR16-AU,200,451.60,46,178.10,246,629.70,20150201
CGG_BR22-AU,483,1136.20,94,364.95,577,1501.15,20150201
CGG_BR23-AU,610,1748.55,234,1197.95,844,2946.50,20150201
CGG_BR26-AU,676,1620.35,148,558.05,824,2178.40,20150201
CGG_BR31-AU,809,1976.30,172,784.05,981,2760.35,20150201
CGG_BR32-AU,679,1513.85,57,178.65,736,1692.50,20150201
CGG_BR33-AU,309,719.30,30,121.85,339,841.15,20150201
CGG_BR34-AU,1381,2751.75,113,334.20,1494,3085.95,20150201
CGG_BR35-AU,748,1840.05,114,502.25,862,2342.30,20150201
CGG_BR41-AU,163,648.15,146,851.45,309,1499.60,20150201
CGG_BR42-AU,677,1700.10,114,462.40,791,2162.50,20150201
CGG_BR43-AU,91,360.70,158,916.85,249,1277.55,20150201
CGG_BR44-AU,301,773.95,37,160.00,338,933.95,20150201
CGG_BR45-AU,77,357.15,152,899.85,229,1257.00,20150201
CGG_BS11-AU,131,698.50,221,1305.60,352,2004.10,20150201
CGG_BS12-AU,323,970.65,57,274.95,380,1245.60,20150201
CGG_BS13-AU,89,478.05,190,1135.25,279,1613.30,20150201
CGG_BS16-AU,123,544.80,139,822.85,262,1367.65,20150201
CGG_BS17-AU,463,1265.40,90,726.20,553,1991.60,20150201
CGG_BS18-AU,479,1277.05,128,644.65,607,1921.70,20150201
CGG_BS21-AU,1373,3158.85,146,523.10,1519,3681.95,20150201
CGG_BS22-AU,967,1926.05,70,221.15,1037,2147.20,20150201
CGG_BS23-AU,981,2284.60,109,378.60,1090,2663.20,20150201
CGG_BS24-AU,1138,2361.35,89,273.65,1227,2635.00,20150201
CGG_BS25-AU,1339,3076.25,84,278.60,1423,3354.85,20150201
CGG_BS26-AU,1748,4120.45,231,820.35,1979,4940.80,20150201
CGG_BS27-AU,2199,5896.85,269,1006.10,2468,6902.95,20150201
CGG_BS29-AU,837,2441.65,123,485.50,960,2927.15,20150201
CGG_BS31-AU,751,2094.00,72,266.85,823,2360.85,20150201
CGG_BS32-AU,1094,3106.80,129,483.00,1223,3589.80,20150201
CGG_BS34-AU,135,399.80,8,33.75,143,433.55,20150201
CGG_BS35-AU,700,1942.55,86,337.30,786,2279.85,20150201
CGG_BS36-AU,1920,5485.15,209,808.60,2129,6293.75,20150201
CGG_BS37-AU,1759,5141.55,212,786.10,1971,5927.65,20150201
CGG_BS51-AU,501,1890.05,99,468.65,600,2358.70,20150201
CGG_BS52-AU,356,1384.35,70,389.30,426,1773.65,20150201
CGG_BS53-AU,627,2527.45,135,763.55,762,3291.00,20150201
CGG_BS54-AU,612,2310.95,107,618.70,719,2929.65,20150201
CGG_CCX1-AU,181,988.95,221,2676.00,402,3664.95,20150201
CGG_CCX2-AU,210,1415.90,176,2321.20,386,3737.10,20150201
CGG_CCX3-AU,27,147.00,40,502.50,67,649.50,20150201
CGG_CCX4-AU,28,155.05,55,645.00,83,800.05,20150201
CGG_CCX5-AU,242,1842.60,241,3355.50,483,5198.10,20150201
CGG_CCX6-AU,40,267.30,78,1033.70,118,1301.00,20150201
CGG_CL11-AU,728,1749.50,111,407.45,839,2156.95,20150201
CGG_CLX2-AU,882,1981.15,105,372.40,987,2353.55,20150201
CGG_CPX1-AU,1860,5766.05,374,1770.95,2234,7537.00,20150201
CGG_CPX2-AU,1113,3451.40,220,1022.85,1333,4474.25,20150201
CGG_CS21-AU,749,2427.00,226,1312.40,975,3739.40,20150201
CGG_CS22-AU,623,1486.50,89,305.55,712,1792.05,20150201
CGG_CUX2-AU,306,745.85,98,402.45,404,1148.30,20150201
CGG_EB29-AU,417,1278.05,79,382.45,496,1660.50,20150201
CGG_EB31-AU,768,2170.90,125,494.20,893,2665.10,20150201
CGG_EB32-AU,787,2065.75,101,441.80,888,2507.55,20150201
CGG_EB33-AU,968,2560.95,188,820.40,1156,3381.35,20150201
CGG_EB34-AU,492,1230.05,48,199.35,540,1429.40,20150201
CGG_EB35-AU,1053,3018.85,220,964.15,1273,3983.00,20150201
CGG_EB36-AU,1107,3085.05,171,721.65,1278,3806.70,20150201
CGG_EB41-AU,681,2035.70,100,631.20,781,2666.90,20150201
CGG_EB42-AU,147,622.15,82,472.75,229,1094.90,20150201
CGG_EB44-AU,115,453.60,140,815.75,255,1269.35,20150201
CGG_EB46-AU,110,458.50,90,527.75,200,986.25,20150201
CGG_FM21-AU,638,2536.80,282,3049.20,920,5586.00,20150201
CGG_FM22-AU,421,1607.55,335,3996.55,756,5604.10,20150201
CGG_FM23-AU,370,1531.10,305,3856.70,675,5387.80,20150201
CGG_FM24-AU,362,1578.15,282,3529.25,644,5107.40,20150201
CGG_FS21-AU,236,894.40,113,1300.50,349,2194.90,20150201
CGG_FS22-AU,407,1253.10,86,492.45,493,1745.55,20150201
CGG_FS23-AU,172,571.00,155,1965.55,327,2536.55,20150201
CGG_FS24-AU,435,1242.15,95,529.30,530,1771.45,20150201
CGG_FS25-AU,394,1196.10,123,639.30,517,1835.40,20150201
CGG_FS26-AU,367,1176.60,119,691.25,486,1867.85,20150201
CGG_FS31-AU,989,2249.55,106,377.40,1095,2626.95,20150201
CGG_FS32-AU,1206,2789.30,153,570.45,1359,3359.75,20150201
CGG_FS33-AU,1801,3690.95,145,449.70,1946,4140.65,20150201
CGG_GC13-AU,180,759.55,177,1012.85,357,1772.40,20150201
CGG_GH11-AU,111,290.25,25,103.70,136,393.95,20150201
CGG_GH15-AU,186,470.05,94,430.60,280,900.65,20150201
CGG_GH21-AU,470,884.55,77,257.35,547,1141.90,20150201
CGG_GH23-AU,890,1645.50,137,484.20,1027,2129.70,20150201
CGG_GH24-AU,1486,2966.25,213,715.85,1699,3682.10,20150201
CGG_GH31-AU,1552,3076.65,145,502.95,1697,3579.60,20150201
CGG_GH32-AU,1299,2724.30,156,510.40,1455,3234.70,20150201
CGG_GH33-AU,846,2167.45,107,547.40,953,2714.85,20150201
CGG_GH34-AU,1239,3064.55,114,367.30,1353,3431.85,20150201
CGG_GH36-AU,1418,3422.70,94,326.10,1512,3748.80,20150201
CGG_GHX1-AU,952,2740.60,230,1226.75,1182,3967.35,20150201
CGG_GHX3-AU,553,1413.85,122,647.45,675,2061.30,20150201
CGG_GHX5-AU,481,1313.50,142,785.55,623,2099.05,20150201
CGG_GM11-AU,132,440.65,61,277.50,193,718.15,20150201
CGG_GM16-AU,174,498.20,66,280.00,240,778.20,20150201
CGG_HAY1-AU,349,2657.05,924,8219.55,1273,10876.60,20150201
CGG_HAY2-AU,467,3384.15,884,7812.90,1351,11197.05,20150201
CGG_HAY3-AU,942,4647.30,894,7659.65,1836,12306.95,20150201
CGG_JSX1-AU,1043,2330.60,143,514.25,1186,2844.85,20150201
CGG_JSX2-AU,1144,2551.20,181,631.60,1325,3182.80,20150201
CGG_LM11-AU,825,1729.60,121,461.10,946,2190.70,20150201
CGG_LM12-AU,857,1369.05,68,217.95,925,1587.00,20150201
CGG_LM13-AU,0,0.00,0,0.00,0,0.00,20150201
CGG_LM14-AU,539,934.15,51,173.00,590,1107.15,20150201
CGG_LM15-AU,505,1052.75,82,304.25,587,1357.00,20150201
CGG_LM16-AU,812,1761.85,114,456.15,926,2218.00,20150201
CGG_LM30-AU,979,1681.45,79,224.15,1058,1905.60,20150201
CGG_LM32-AU,1435,2316.05,97,277.25,1532,2593.30,20150201
CGG_LM41-AU,1138,1916.85,71,182.90,1209,2099.75,20150201
CGG_LM42-AU,991,1590.50,80,230.40,1071,1820.90,20150201
CGG_LM43-AU,1621,2136.05,83,217.20,1704,2353.25,20150201
CGG_LM44-AU,1831,2896.70,127,381.00,1958,3277.70,20150201
CGG_LMX2-AU,361,1927.25,183,2074.95,544,4002.20,20150201
CGG_LR11-AU,924,2065.10,81,280.60,1005,2345.70,20150201
CGG_LR12-AU,1450,3034.00,112,319.15,1562,3353.15,20150201
CGG_LR13-AU,2323,4975.85,196,574.60,2519,5550.45,20150201
CGG_LR14-AU,924,1864.90,93,294.85,1017,2159.75,20150201
CGG_LR15-AU,1263,2893.65,154,542.40,1417,3436.05,20150201
CGG_LR16-AU,1155,2674.95,151,508.00,1306,3182.95,20150201
CGG_LR31-AU,361,989.95,46,244.35,407,1234.30,20150201
CGG_LR33-AU,562,1563.80,108,597.45,670,2161.25,20150201
CGG_LR43-AU,808,2285.65,97,401.80,905,2687.45,20150201
CGG_LR47-AU,1158,3522.10,160,792.95,1318,4315.05,20150201
CGG_MB11-AU,839,1761.80,89,273.50,928,2035.30,20150201
CGG_MB12-AU,1208,2651.75,121,389.20,1329,3040.95,20150201
CGG_MB13-AU,749,1604.95,13,45.00,762,1649.95,20150201
CGG_MB14-AU,844,1631.20,79,268.70,923,1899.90,20150201
CGG_MB15-AU,574,1032.25,52,166.20,626,1198.45,20150201
CGG_MB16-AU,765,1460.35,72,216.85,837,1677.20,20150201
CGG_MB17-AU,1077,1928.10,149,571.60,1226,2499.70,20150201
CGG_MB23-AU,1408,2303.70,90,252.80,1498,2556.50,20150201
CGG_MB31-AU,2102,3173.75,110,263.20,2212,3436.95,20150201
CGG_MB32-AU,2027,2724.70,100,236.40,2127,2961.10,20150201
CGG_MB33-AU,1708,2815.80,101,314.10,1809,3129.90,20150201
CGG_MB34-AU,1683,2449.25,85,224.65,1768,2673.90,20150201
CGG_MB35-AU,1198,2462.55,130,495.40,1328,2957.95,20150201
CGG_MB36-AU,2163,3229.45,124,377.65,2287,3607.10,20150201
CGG_MB37-AU,1044,1876.50,103,373.60,1147,2250.10,20150201
CGG_MB38-AU,1848,3017.25,67,184.80,1915,3202.05,20150201
CGG_MB41-AU,1576,2638.35,132,357.55,1708,2995.90,20150201
CGG_MB42-AU,1012,2541.50,78,265.45,1090,2806.95,20150201
CGG_MB44-AU,1058,2229.95,77,214.75,1135,2444.70,20150201
CGG_MBX1-AU,1311,3509.75,193,688.50,1504,4198.25,20150201
CGG_MBX2-AU,1056,2754.90,236,838.70,1292,3593.60,20150201
CGG_MBX4-AU,828,2074.45,139,506.15,967,2580.60,20150201
CGG_MC21-AU,1439,3767.85,159,997.95,1598,4765.80,20150201
CGG_MC22-AU,1536,3859.00,173,976.65,1709,4835.65,20150201
CGG_MC23-AU,838,2092.50,82,498.70,920,2591.20,20150201
CGG_MC31-AU,646,1448.80,111,493.50,757,1942.30,20150201
CGG_MC32-AU,344,1107.05,75,447.40,419,1554.45,20150201
CGG_MC33-AU,439,1432.10,68,357.45,507,1789.55,20150201
CGG_MK31-AU,200,643.20,65,320.55,265,963.75,20150201
CGG_MK34-AU,227,665.55,56,235.55,283,901.10,20150201
CGG_MK35-AU,174,417.55,16,57.45,190,475.00,20150201
CGG_MM41-AU,2049,3460.95,118,307.05,2167,3768.00,20150201
CGG_MS10-AU,473,869.80,60,203.70,533,1073.50,20150201
CGG_MS11-AU,1158,2142.15,129,392.25,1287,2534.40,20150201
CGG_MS12-AU,1654,2827.85,132,399.65,1786,3227.50,20150201
CGG_MS21-AU,1728,2904.70,126,382.75,1854,3287.45,20150201
CGG_MS30-AU,594,1053.45,56,172.30,650,1225.75,20150201
CGG_MS31-AU,2234,4270.90,242,681.15,2476,4952.05,20150201
CGG_MS32-AU,1384,2436.55,156,441.50,1540,2878.05,20150201
CGG_MS41-AU,1100,1870.10,93,244.70,1193,2114.80,20150201
CGG_MS42-AU,1932,2538.00,152,322.30,2084,2860.30,20150201
CGG_MS43-AU,1821,3062.50,149,414.55,1970,3477.05,20150201
CGG_MS44-AU,1597,2287.10,105,215.60,1702,2502.70,20150201
CGG_MS46-AU,1338,1989.85,30,74.90,1368,2064.75,20150201
CGG_MY21-AU,1086,2245.15,83,284.75,1169,2529.90,20150201
CGG_MY22-AU,1080,2650.25,69,234.85,1149,2885.10,20150201
CGG_MY23-AU,902,1981.35,53,167.40,955,2148.75,20150201
CGG_MY24-AU,889,2097.90,69,233.60,958,2331.50,20150201
CGG_MY25-AU,1140,2436.70,91,304.85,1231,2741.55,20150201
CGG_MY26-AU,994,2447.65,77,271.20,1071,2718.85,20150201
CGG_MY31-AU,524,1286.70,71,269.95,595,1556.65,20150201
CGG_MY32-AU,599,1450.80,62,223.05,661,1673.85,20150201
CGG_MY33-AU,310,846.10,75,296.15,385,1142.25,20150201
CGG_MY34-AU,341,1071.95,49,211.85,390,1283.80,20150201
CGG_MY35-AU,252,681.25,33,126.20,285,807.45,20150201
CGG_MY41-AU,1865,4136.95,177,567.25,2042,4704.20,20150201
CGG_MY42-AU,2260,4442.40,139,387.35,2399,4829.75,20150201
CGG_MY43-AU,895,2695.10,94,334.80,989,3029.90,20150201
CGG_MY44-AU,462,1345.25,42,170.60,504,1515.85,20150201
CGG_MY45-AU,875,2669.90,126,494.30,1001,3164.20,20150201
CGG_MY46-AU,1820,5792.60,164,661.20,1984,6453.80,20150201
CGG_MY47-AU,1261,3891.35,188,730.50,1449,4621.85,20150201
CGG_MY51-AU,908,3110.30,177,919.85,1085,4030.15,20150201
CGG_MY52-AU,920,3466.60,302,2142.95,1222,5609.55,20150201
CGG_MY53-AU,660,2336.10,170,925.45,830,3261.55,20150201
CGG_MY54-AU,865,3504.40,239,1624.80,1104,5129.20,20150201
CGG_MY55-AU,927,3343.05,225,1189.80,1152,4532.85,20150201
CGG_MY56-AU,1033,4197.35,311,2242.30,1344,6439.65,20150201
CGG_MY57-AU,918,3335.15,217,1142.30,1135,4477.45,20150201
CGG_PNR1-AU,712,2150.15,352,1056.00,1064,3206.15,20150201
CGG_PNR2-AU,37,112.00,23,69.00,60,181.00,20150201
CGG_RBX4-AU,279,813.80,52,221.20,331,1035.00,20150201
CGG_RBX5-AU,115,465.05,63,308.75,178,773.80,20150201
CGG_RBX6-AU,371,1699.45,370,1817.45,741,3516.90,20150201
CGG_RBX7-AU,322,1320.85,246,1186.75,568,2507.60,20150201
CGG_RS11-AU,735,1222.85,48,173.65,783,1396.50,20150201
CGG_RS13-AU,469,748.40,49,174.95,518,923.35,20150201
CGG_RS14-AU,1261,1471.65,39,105.40,1300,1577.05,20150201
CGG_RS15-AU,658,1259.95,92,299.85,750,1559.80,20150201
CGG_RS16-AU,1328,2059.20,74,253.00,1402,2312.20,20150201
CGG_RS20-AU,1375,2144.35,104,292.10,1479,2436.45,20150201
CGG_RS21-AU,1609,2613.80,125,350.50,1734,2964.30,20150201
CGG_RS22-AU,2354,3605.75,153,407.75,2507,4013.50,20150201
CGG_RS23-AU,1856,3261.40,174,550.85,2030,3812.25,20150201
CGG_RS30-AU,1466,2618.05,112,296.45,1578,2914.50,20150201
CGG_RS31-AU,1563,2921.15,125,402.80,1688,3323.95,20150201
CGG_RS32-AU,822,1648.80,65,216.10,887,1864.90,20150201
CGG_RS33-AU,835,1641.45,78,270.55,913,1912.00,20150201
CGG_RS41-AU,1265,2529.30,93,302.40,1358,2831.70,20150201
CGG_RS42-AU,1381,3144.75,145,517.95,1526,3662.70,20150201
CGG_RS43-AU,735,1553.80,92,264.85,827,1818.65,20150201
CGG_RS44-AU,571,1284.45,49,171.20,620,1455.65,20150201
CGG_RS45-AU,1329,2702.90,141,451.00,1470,3153.90,20150201
CGG_RS46-AU,882,2123.85,93,331.75,975,2455.60,20150201
CGG_RS50-AU,475,1010.90,0,0.00,475,1010.90,20150201
CGG_RS53-AU,852,2094.30,132,514.25,984,2608.55,20150201
CGG_RSX1-AU,426,536.45,26,93.00,452,629.45,20150201
CGG_RSX2-AU,671,1315.40,64,230.50,735,1545.90,20150201
CGG_RSX3-AU,574,1133.90,46,174.35,620,1308.25,20150201
CGG_RT12-AU,1099,2912.95,157,789.55,1256,3702.50,20150201
CGG_SS31-AU,893,1647.00,60,195.45,953,1842.45,20150201
CGG_SS32-AU,652,1305.75,67,268.60,719,1574.35,20150201
CGG_SW30-AU,391,1369.80,121,1020.50,512,2390.30,20150201
CGG_SW31-AU,1111,3111.80,122,456.10,1233,3567.90,20150201
CGG_SW32-AU,395,1411.35,144,1279.35,539,2690.70,20150201
CGG_SW33-AU,610,1805.20,104,406.20,714,2211.40,20150201
CGG_SW34-AU,625,2491.90,259,2175.35,884,4667.25,20150201
CGG_SW35-AU,650,2015.10,105,434.30,755,2449.40,20150201
CGG_TM10-AU,1802,5004.90,492,2179.00,2294,7183.90,20150201
CGG_TMX3-AU,984,3269.40,317,2212.35,1301,5481.75,20150201
CGG_TMX4-AU,1485,4745.00,356,2175.30,1841,6920.30,20150201
CGG_TMX5-AU,1503,4926.00,674,4859.10,2177,9785.10,20150201
CGG_TMX6-AU,1564,5494.55,574,4075.30,2138,9569.85,20150201
CGG_TMX7-AU,1427,4102.00,507,2351.65,1934,6453.65,20150201
CGG_TMX8-AU,1998,6173.20,1239,5821.55,3237,11994.75,20150201
CGG_TMX9-AU,2104,5792.15,540,2355.85,2644,8148.00,20150201
CGG_TPX1-AU,794,1885.75,217,808.00,1011,2693.75,20150201
CGG_US10-AU,1058,1984.85,90,290.55,1148,2275.40,20150201
CGG_WB11-AU,39,218.55,142,846.60,181,1065.15,20150201
CGG_WB12-AU,64,236.95,21,103.85,85,340.80,20150201
CGG_WB13-AU,44,258.50,129,765.10,173,1023.60,20150201
CGG_WB14-AU,0,0.00,0,0.00,0,0.00,20150201
CGG_WB15-AU,66,327.30,162,965.25,228,1292.55,20150201
CGG_WB16-AU,184,649.35,84,407.10,268,1056.45,20150201
CGG_WBF1-AU,348,894.05,39,189.35,387,1083.40,20150201
CGG_WBF2-AU,187,527.65,36,174.95,223,702.60,20150201
CGG_WES1-AU,362,1663.20,96,664.95,458,2328.15,20150201
CGG_WES2-AU,605,2726.85,203,1366.65,808,4093.50,20150201
CGG_YA11-AU,716,1358.65,52,151.75,768,1510.40,20150201
CGG_YA13-AU,1889,3428.95,147,393.95,2036,3822.90,20150201
CGG_YA14-AU,1027,1867.05,99,267.20,1126,2134.25,20150201
CGG_YA18-AU,1124,2131.35,87,222.40,1211,2353.75,20150201
CGG_YA20-AU,1459,3031.90,135,441.05,1594,3472.95,20150201
CGG_YA21-AU,1018,1875.55,89,257.90,1107,2133.45,20150201
CGG_YA23-AU,877,1698.20,65,239.90,942,1938.10,20150201
CGG_YA31-AU,1526,3654.70,157,547.95,1683,4202.65,20150201
CGG_YA32-AU,1074,2346.30,98,344.90,1172,2691.20,20150201
CGG_YA34-AU,979,2658.95,134,706.85,1113,3365.80,20150201
CGG_YA35-AU,1025,3086.70,187,911.65,1212,3998.35,20150201
CGG_YA36-AU,614,1707.45,129,688.70,743,2396.15,20150201
CGG_YAX1-AU,637,1804.15,116,561.80,753,2365.95,20150201
CGG_YAX2-AU,637,2009.70,95,417.45,732,2427.15,20150201
CGG_YAX3-AU,245,671.40,39,196.25,284,867.65,20150201
CGG_YAX4-AU,393,1065.10,75,358.70,468,1423.80,20150201
CGG_YCX1-AU,308,783.30,54,252.45,362,1035.75,20150201
CGG_AP21-AU,322,617.90,29,121.25,351,739.15,20150101
CGG_BC13-AU,58,311.50,103,618.00,161,929.50,20150101
CGG_BC14-AU,77,408.90,122,732.00,199,1140.90,20150101
CGG_BC21-AU,215,771.45,151,1891.85,366,2663.30,20150101
CGG_BC41-AU,254,1040.25,150,890.00,404,1930.25,20150101
CGG_BC42-AU,98,415.75,69,391.25,167,807.00,20150101
CGG_BC43-AU,253,972.90,256,1509.45,509,2482.35,20150101
CGG_BR14-AU,76,188.75,12,51.25,88,240.00,20150101
CGG_BR15-AU,131,375.45,59,272.50,190,647.95,20150101
CGG_BR16-AU,226,490.80,19,53.70,245,544.50,20150101
CGG_BR22-AU,451,1160.95,59,204.30,510,1365.25,20150101
CGG_BR23-AU,533,1492.75,193,1076.75,726,2569.50,20150101
CGG_BR26-AU,650,1589.25,99,363.05,749,1952.30,20150101
CGG_BR31-AU,768,2069.30,126,581.75,894,2651.05,20150101
CGG_BR32-AU,672,1595.35,50,169.25,722,1764.60,20150101
CGG_BR33-AU,283,779.75,27,103.10,310,882.85,20150101
CGG_BR34-AU,1308,2764.45,99,310.55,1407,3075.00,20150101
CGG_BR35-AU,797,2205.45,104,556.80,901,2762.25,20150101
CGG_BR41-AU,161,663.50,125,730.60,286,1394.10,20150101
CGG_BR42-AU,588,1649.85,118,493.05,706,2142.90,20150101
CGG_BR43-AU,102,434.00,97,575.25,199,1009.25,20150101
CGG_BR44-AU,303,898.75,56,235.60,359,1134.35,20150101
CGG_BR45-AU,106,471.55,124,732.75,230,1204.30,20150101
CGG_BS11-AU,179,869.80,180,1056.70,359,1926.50,20150101
CGG_BS12-AU,445,1462.15,77,373.70,522,1835.85,20150101
CGG_BS13-AU,110,573.10,148,876.85,258,1449.95,20150101
CGG_BS16-AU,128,597.10,106,628.00,234,1225.10,20150101
CGG_BS17-AU,533,1693.05,63,462.50,596,2155.55,20150101
CGG_BS18-AU,437,1226.40,96,501.85,533,1728.25,20150101
CGG_BS21-AU,1256,2868.85,92,323.05,1348,3191.90,20150101
CGG_BS22-AU,943,1791.15,55,154.85,998,1946.00,20150101
CGG_BS23-AU,814,1854.50,79,281.15,893,2135.65,20150101
CGG_BS24-AU,1014,2123.70,84,273.70,1098,2397.40,20150101
CGG_BS25-AU,1205,2792.00,115,389.85,1320,3181.85,20150101
CGG_BS26-AU,1755,4043.45,172,554.05,1927,4597.50,20150101
CGG_BS27-AU,1873,4922.35,204,756.00,2077,5678.35,20150101
CGG_BS29-AU,766,2229.40,94,383.65,860,2613.05,20150101
CGG_BS31-AU,688,1984.95,57,228.10,745,2213.05,20150101
CGG_BS32-AU,954,2677.95,119,437.95,1073,3115.90,20150101
CGG_BS34-AU,108,306.10,11,40.60,119,346.70,20150101
CGG_BS35-AU,684,2021.75,57,220.60,741,2242.35,20150101
CGG_BS36-AU,1775,5072.25,207,801.05,1982,5873.30,20150101
CGG_BS37-AU,1578,4532.20,151,573.60,1729,5105.80,20150101
CGG_BS51-AU,487,1789.75,112,631.80,599,2421.55,20150101
CGG_BS52-AU,301,1131.10,56,317.45,357,1448.55,20150101
CGG_BS53-AU,425,1592.15,84,464.95,509,2057.10,20150101
CGG_BS54-AU,451,1752.40,79,447.45,530,2199.85,20150101
CGG_CCX1-AU,121,664.60,123,1646.20,244,2310.80,20150101
CGG_CCX2-AU,76,514.85,76,903.10,152,1417.95,20150101
CGG_CCX3-AU,14,86.70,4,67.50,18,154.20,20150101
CGG_CCX4-AU,8,66.00,11,127.50,19,193.50,20150101
CGG_CCX5-AU,148,1106.75,91,1276.20,239,2382.95,20150101
CGG_CCX6-AU,22,126.45,47,657.50,69,783.95,20150101
CGG_CL11-AU,649,1628.70,88,326.85,737,1955.55,20150101
CGG_CLX2-AU,780,1718.80,80,288.65,860,2007.45,20150101
CGG_CPX1-AU,1706,5610.45,287,1379.65,1993,6990.10,20150101
CGG_CPX2-AU,1372,4538.35,227,1079.70,1599,5618.05,20150101
CGG_CS21-AU,670,2099.65,134,735.50,804,2835.15,20150101
CGG_CS22-AU,538,1276.25,75,279.95,613,1556.20,20150101
CGG_CUX2-AU,330,830.10,58,220.00,388,1050.10,20150101
CGG_EB29-AU,449,1392.75,73,378.05,522,1770.80,20150101
CGG_EB31-AU,612,1862.15,90,387.40,702,2249.55,20150101
CGG_EB32-AU,719,2007.80,108,495.55,827,2503.35,20150101
CGG_EB33-AU,1162,3428.95,169,741.70,1331,4170.65,20150101
CGG_EB34-AU,431,1160.00,50,215.60,481,1375.60,20150101
CGG_EB35-AU,1078,3400.20,158,738.55,1236,4138.75,20150101
CGG_EB36-AU,1153,3450.90,141,637.35,1294,4088.25,20150101
CGG_EB41-AU,693,2312.10,114,916.80,807,3228.90,20150101
CGG_EB42-AU,153,653.65,59,334.85,212,988.50,20150101
CGG_EB44-AU,118,417.40,117,680.10,235,1097.50,20150101
CGG_EB46-AU,84,328.90,71,407.25,155,736.15,20150101
CGG_FM21-AU,463,1523.35,73,585.60,536,2108.95,20150101
CGG_FM22-AU,236,825.55,136,1701.75,372,2527.30,20150101
CGG_FM23-AU,253,1044.35,217,2874.30,470,3918.65,20150101
CGG_FM24-AU,223,862.30,153,2006.85,376,2869.15,20150101
CGG_FS21-AU,260,757.60,86,838.00,346,1595.60,20150101
CGG_FS22-AU,202,507.50,30,167.45,232,674.95,20150101
CGG_FS23-AU,124,367.90,96,1329.95,220,1697.85,20150101
CGG_FS24-AU,235,568.75,27,135.00,262,703.75,20150101
CGG_FS25-AU,289,804.05,61,289.35,350,1093.40,20150101
CGG_FS26-AU,208,563.00,23,121.20,231,684.20,20150101
CGG_FS31-AU,730,1588.80,59,192.40,789,1781.20,20150101
CGG_FS32-AU,738,1701.20,78,288.65,816,1989.85,20150101
CGG_FS33-AU,1393,2812.20,91,236.65,1484,3048.85,20150101
CGG_GC13-AU,151,654.60,142,830.70,293,1485.30,20150101
CGG_GH11-AU,51,130.50,9,35.60,60,166.10,20150101
CGG_GH15-AU,153,424.05,44,186.85,197,610.90,20150101
CGG_GH21-AU,378,742.25,36,107.45,414,849.70,20150101
CGG_GH23-AU,721,1293.15,87,284.30,808,1577.45,20150101
CGG_GH24-AU,1158,2330.00,112,358.55,1270,2688.55,20150101
CGG_GH31-AU,1218,2355.45,74,229.25,1292,2584.70,20150101
CGG_GH32-AU,949,1807.70,119,353.55,1068,2161.25,20150101
CGG_GH33-AU,547,1328.55,50,243.05,597,1571.60,20150101
CGG_GH34-AU,839,2082.50,72,258.10,911,2340.60,20150101
CGG_GH36-AU,917,2208.50,56,190.50,973,2399.00,20150101
CGG_GHX1-AU,769,2426.10,136,680.55,905,3106.65,20150101
CGG_GHX3-AU,367,1069.25,87,466.80,454,1536.05,20150101
CGG_GHX5-AU,279,864.00,69,345.00,348,1209.00,20150101
CGG_GM11-AU,93,322.20,38,171.85,131,494.05,20150101
CGG_GM16-AU,113,340.05,22,90.60,135,430.65,20150101
CGG_HAY1-AU,365,2588.25,677,5942.10,1042,8530.35,20150101
CGG_HAY2-AU,361,2296.40,601,5269.50,962,7565.90,20150101
CGG_HAY3-AU,605,2720.20,456,3870.10,1061,6590.30,20150101
CGG_JSX1-AU,977,2151.15,125,423.05,1102,2574.20,20150101
CGG_JSX2-AU,1017,2272.90,108,356.05,1125,2628.95,20150101
CGG_LM11-AU,670,1311.60,61,193.00,731,1504.60,20150101
CGG_LM12-AU,673,1107.80,61,196.75,734,1304.55,20150101
CGG_LM13-AU,0,0.00,0,0.00,0,0.00,20150101
CGG_LM14-AU,482,783.35,40,112.45,522,895.80,20150101
CGG_LM15-AU,362,724.10,33,119.35,395,843.45,20150101
CGG_LM16-AU,574,1214.50,69,272.40,643,1486.90,20150101
CGG_LM30-AU,763,1345.60,61,174.15,824,1519.75,20150101
CGG_LM32-AU,1298,2295.30,104,311.60,1402,2606.90,20150101
CGG_LM41-AU,1036,1868.45,75,228.00,1111,2096.45,20150101
CGG_LM42-AU,876,1534.75,58,152.35,934,1687.10,20150101
CGG_LM43-AU,1448,1890.05,68,174.05,1516,2064.10,20150101
CGG_LM44-AU,1681,2560.60,88,259.15,1769,2819.75,20150101
CGG_LMX2-AU,134,399.50,59,654.35,193,1053.85,20150101
CGG_LR11-AU,856,1807.70,50,163.10,906,1970.80,20150101
CGG_LR12-AU,1249,2570.55,120,357.25,1369,2927.80,20150101
CGG_LR13-AU,2103,4426.00,142,389.05,2245,4815.05,20150101
CGG_LR14-AU,868,1832.25,60,160.45,928,1992.70,20150101
CGG_LR15-AU,1081,2525.95,115,396.85,1196,2922.80,20150101
CGG_LR16-AU,897,2036.95,124,419.25,1021,2456.20,20150101
CGG_LR31-AU,318,1043.10,71,414.30,389,1457.40,20150101
CGG_LR33-AU,529,1879.75,153,945.55,682,2825.30,20150101
CGG_LR43-AU,759,2121.90,80,308.05,839,2429.95,20150101
CGG_LR47-AU,1024,3044.90,165,789.15,1189,3834.05,20150101
CGG_MB11-AU,748,1720.05,71,224.20,819,1944.25,20150101
CGG_MB12-AU,1077,2461.40,118,401.70,1195,2863.10,20150101
CGG_MB13-AU,682,1450.00,48,158.05,730,1608.05,20150101
CGG_MB14-AU,762,1554.35,54,173.65,816,1728.00,20150101
CGG_MB15-AU,478,920.05,33,105.55,511,1025.60,20150101
CGG_MB16-AU,685,1400.20,54,174.90,739,1575.10,20150101
CGG_MB17-AU,977,1861.50,113,392.85,1090,2254.35,20150101
CGG_MB23-AU,1361,2456.95,84,243.40,1445,2700.35,20150101
CGG_MB31-AU,1656,2935.90,102,336.55,1758,3272.45,20150101
CGG_MB32-AU,1838,2769.25,96,227.85,1934,2997.10,20150101
CGG_MB33-AU,1722,3084.60,115,316.05,1837,3400.65,20150101
CGG_MB34-AU,1688,2622.45,90,221.95,1778,2844.40,20150101
CGG_MB35-AU,1313,2636.30,131,481.80,1444,3118.10,20150101
CGG_MB36-AU,2206,3477.95,124,286.95,2330,3764.90,20150101
CGG_MB37-AU,1212,2343.10,89,259.10,1301,2602.20,20150101
CGG_MB38-AU,1676,2741.60,79,218.60,1755,2960.20,20150101
CGG_MB41-AU,1356,2302.05,98,287.10,1454,2589.15,20150101
CGG_MB42-AU,796,1873.30,53,180.55,849,2053.85,20150101
CGG_MB44-AU,736,1531.20,57,163.00,793,1694.20,20150101
CGG_MBX1-AU,1272,3573.45,152,586.80,1424,4160.25,20150101
CGG_MBX2-AU,1041,2804.75,152,556.80,1193,3361.55,20150101
CGG_MBX4-AU,733,1965.30,103,396.20,836,2361.50,20150101
CGG_MC21-AU,1095,2781.90,111,709.25,1206,3491.15,20150101
CGG_MC22-AU,1381,3506.20,103,500.45,1484,4006.65,20150101
CGG_MC23-AU,758,1993.35,75,416.85,833,2410.20,20150101
CGG_MC31-AU,613,1410.85,78,376.55,691,1787.40,20150101
CGG_MC32-AU,251,854.40,55,353.65,306,1208.05,20150101
CGG_MC33-AU,313,1120.40,78,522.45,391,1642.85,20150101
CGG_MK31-AU,316,1346.60,86,460.55,402,1807.15,20150101
CGG_MK34-AU,212,702.95,48,247.45,260,950.40,20150101
CGG_MK35-AU,152,444.45,28,159.35,180,603.80,20150101
CGG_MM41-AU,1883,3275.75,128,333.45,2011,3609.20,20150101
CGG_MS10-AU,410,784.25,48,143.10,458,927.35,20150101
CGG_MS11-AU,1033,1985.40,80,229.20,1113,2214.60,20150101
CGG_MS12-AU,1503,2590.45,139,406.55,1642,2997.00,20150101
CGG_MS21-AU,1516,2704.25,119,358.45,1635,3062.70,20150101
CGG_MS30-AU,598,1120.45,39,99.80,637,1220.25,20150101
CGG_MS31-AU,1903,3956.90,183,604.10,2086,4561.00,20150101
CGG_MS32-AU,1320,2505.00,100,265.85,1420,2770.85,20150101
CGG_MS41-AU,1023,1867.70,67,186.10,1090,2053.80,20150101
CGG_MS42-AU,1708,2524.60,116,249.90,1824,2774.50,20150101
CGG_MS43-AU,1875,3250.20,138,379.55,2013,3629.75,20150101
CGG_MS44-AU,1531,2397.50,97,224.60,1628,2622.10,20150101
CGG_MS46-AU,1288,2024.40,4,7.45,1292,2031.85,20150101
CGG_MY21-AU,946,1821.30,47,154.35,993,1975.65,20150101
CGG_MY22-AU,822,1989.25,54,199.25,876,2188.50,20150101
CGG_MY23-AU,759,1625.05,40,124.90,799,1749.95,20150101
CGG_MY24-AU,833,1988.35,53,178.10,886,2166.45,20150101
CGG_MY25-AU,984,2038.85,58,179.30,1042,2218.15,20150101
CGG_MY26-AU,942,2291.25,55,176.80,997,2468.05,20150101
CGG_MY31-AU,437,1054.00,68,263.70,505,1317.70,20150101
CGG_MY32-AU,458,1115.30,42,152.45,500,1267.75,20150101
CGG_MY33-AU,281,853.50,31,135.00,312,988.50,20150101
CGG_MY34-AU,265,880.05,44,183.10,309,1063.15,20150101
CGG_MY35-AU,232,653.20,25,106.25,257,759.45,20150101
CGG_MY41-AU,1356,2975.70,117,359.85,1473,3335.55,20150101
CGG_MY42-AU,1972,3846.25,50,157.35,2022,4003.60,20150101
CGG_MY43-AU,591,1774.90,66,226.75,657,2001.65,20150101
CGG_MY44-AU,267,757.00,8,30.00,275,787.00,20150101
CGG_MY45-AU,706,2256.65,88,346.20,794,2602.85,20150101
CGG_MY46-AU,1462,4583.90,149,603.10,1611,5187.00,20150101
CGG_MY47-AU,1119,3472.15,149,607.50,1268,4079.65,20150101
CGG_MY51-AU,916,3158.00,158,774.80,1074,3932.80,20150101
CGG_MY52-AU,849,3254.20,258,1822.45,1107,5076.65,20150101
CGG_MY53-AU,574,2043.75,127,716.80,701,2760.55,20150101
CGG_MY54-AU,698,2970.00,199,1383.60,897,4353.60,20150101
CGG_MY55-AU,1073,3816.80,200,1111.75,1273,4928.55,20150101
CGG_MY56-AU,806,3394.30,263,1799.10,1069,5193.40,20150101
CGG_MY57-AU,615,2129.65,121,618.00,736,2747.65,20150101
CGG_PNR1-AU,546,1651.55,256,768.00,802,2419.55,20150101
CGG_PNR2-AU,41,123.00,13,39.00,54,162.00,20150101
CGG_RBX4-AU,607,2224.95,158,684.80,765,2909.75,20150101
CGG_RBX5-AU,420,1683.25,150,720.55,570,2403.80,20150101
CGG_RBX6-AU,432,1871.25,316,1543.00,748,3414.25,20150101
CGG_RBX7-AU,366,1484.60,206,1006.85,572,2491.45,20150101
CGG_RS11-AU,528,828.65,35,109.95,563,938.60,20150101
CGG_RS13-AU,399,576.65,36,133.70,435,710.35,20150101
CGG_RS14-AU,0,0.00,0,0.00,0,0.00,20150101
CGG_RS15-AU,520,916.65,53,189.30,573,1105.95,20150101
CGG_RS16-AU,1190,1736.75,83,204.55,1273,1941.30,20150101
CGG_RS20-AU,1282,2053.75,77,200.40,1359,2254.15,20150101
CGG_RS21-AU,1489,2581.55,100,272.75,1589,2854.30,20150101
CGG_RS22-AU,2305,3656.50,155,410.60,2460,4067.10,20150101
CGG_RS23-AU,1613,2948.30,163,520.30,1776,3468.60,20150101
CGG_RS30-AU,1262,2505.80,138,478.55,1400,2984.35,20150101
CGG_RS31-AU,1450,3010.20,120,402.20,1570,3412.40,20150101
CGG_RS32-AU,728,1672.55,51,214.95,779,1887.50,20150101
CGG_RS33-AU,1028,2175.65,96,333.60,1124,2509.25,20150101
CGG_RS41-AU,1218,2594.10,9,21.25,1227,2615.35,20150101
CGG_RS42-AU,1128,2783.65,130,446.55,1258,3230.20,20150101
CGG_RS43-AU,683,1390.65,75,247.45,758,1638.10,20150101
CGG_RS44-AU,507,1207.05,49,157.40,556,1364.45,20150101
CGG_RS45-AU,1162,2514.20,124,391.10,1286,2905.30,20150101
CGG_RS46-AU,808,1933.65,85,321.80,893,2255.45,20150101
CGG_RS50-AU,409,868.15,0,0.00,409,868.15,20150101
CGG_RS53-AU,747,1905.45,71,265.60,818,2171.05,20150101
CGG_RSX1-AU,416,500.80,11,41.20,427,542.00,20150101
CGG_RSX2-AU,516,943.45,34,123.00,550,1066.45,20150101
CGG_RSX3-AU,482,1003.60,24,71.15,506,1074.75,20150101
CGG_RT12-AU,1061,2810.20,107,479.15,1168,3289.35,20150101
CGG_SS31-AU,839,1342.00,48,155.45,887,1497.45,20150101
CGG_SS32-AU,583,1041.40,45,193.65,628,1235.05,20150101
CGG_SW30-AU,355,1303.85,89,794.30,444,2098.15,20150101
CGG_SW31-AU,937,2659.10,89,342.40,1026,3001.50,20150101
CGG_SW32-AU,413,1447.10,95,923.10,508,2370.20,20150101
CGG_SW33-AU,468,1360.00,59,224.35,527,1584.35,20150101
CGG_SW34-AU,559,2208.35,167,1612.40,726,3820.75,20150101
CGG_SW35-AU,340,978.50,45,180.60,385,1159.10,20150101
CGG_TM10-AU,1725,4668.90,378,1682.25,2103,6351.15,20150101
CGG_TMX3-AU,940,3310.75,241,1605.50,1181,4916.25,20150101
CGG_TMX4-AU,1418,4765.80,296,1832.90,1714,6598.70,20150101
CGG_TMX5-AU,1548,4942.25,494,3459.10,2042,8401.35,20150101
CGG_TMX6-AU,1537,5345.90,381,2586.00,1918,7931.90,20150101
CGG_TMX7-AU,1162,3186.35,302,1339.15,1464,4525.50,20150101
CGG_TMX8-AU,1583,4662.25,729,3363.50,2312,8025.75,20150101
CGG_TMX9-AU,2052,5506.45,415,1759.10,2467,7265.55,20150101
CGG_TPX1-AU,661,1498.70,122,453.05,783,1951.75,20150101
CGG_US10-AU,917,1801.55,75,196.65,992,1998.20,20150101
CGG_WB11-AU,64,341.05,115,680.10,179,1021.15,20150101
CGG_WB12-AU,74,250.30,12,59.00,86,309.30,20150101
CGG_WB13-AU,51,243.35,117,694.35,168,937.70,20150101
CGG_WB14-AU,0,0.00,0,0.00,0,0.00,20150101
CGG_WB15-AU,93,446.65,133,784.50,226,1231.15,20150101
CGG_WB16-AU,208,721.20,74,345.55,282,1066.75,20150101
CGG_WBF1-AU,355,990.65,54,228.10,409,1218.75,20150101
CGG_WBF2-AU,309,902.00,38,146.80,347,1048.80,20150101
CGG_WES1-AU,542,2564.75,130,879.20,672,3443.95,20150101
CGG_WES2-AU,711,3459.40,281,1879.10,992,5338.50,20150101
CGG_YA11-AU,712,1484.65,49,146.15,761,1630.80,20150101
CGG_YA13-AU,1530,3054.10,109,301.50,1639,3355.60,20150101
CGG_YA14-AU,901,1797.00,91,272.85,992,2069.85,20150101
CGG_YA18-AU,903,1912.90,105,316.75,1008,2229.65,20150101
CGG_YA20-AU,1343,2855.30,121,389.20,1464,3244.50,20150101
CGG_YA21-AU,1013,1972.30,59,164.90,1072,2137.20,20150101
CGG_YA23-AU,872,1890.50,64,180.45,936,2070.95,20150101
CGG_YA31-AU,1359,3447.25,115,410.45,1474,3857.70,20150101
CGG_YA32-AU,1004,2403.25,100,368.60,1104,2771.85,20150101
CGG_YA34-AU,825,2490.55,110,632.40,935,3122.95,20150101
CGG_YA35-AU,844,2835.50,137,706.10,981,3541.60,20150101
CGG_YA36-AU,583,1712.05,91,493.05,674,2205.10,20150101
CGG_YAX1-AU,783,2527.35,146,708.60,929,3235.95,20150101
CGG_YAX2-AU,626,2000.80,95,465.50,721,2466.30,20150101
CGG_YAX3-AU,329,1018.35,63,321.80,392,1340.15,20150101
CGG_YAX4-AU,410,1226.95,80,416.85,490,1643.80,20150101
CGG_YCX1-AU,613,1892.00,100,681.75,713,2573.75,20150101
